一人	ひとり
一人静	ひとりしずか
一入	ひとしお
一八	いちはつ
一向	ひたすら
一夏	いちげ
一寸	ちょっと
一年	ひととせ
一廉	ひとかど
一揃	ぴんぞろ
一斤染	いっこんぞめ
一日	ついたち
一昨年	おととし
一昨日	おととい
一昨昨年	さきおととし
一昨昨日	さきおととい
一枚	ひとひら
一枚交	いちまいまぜ
一片	ひとひら
一節切	ひとよぎり
一葉	はらん
一行	ひとく だり
一角獣	ウニコール
一言居士	イチゲンこじ
一越縮緬	ひとこしちりめん
一齣	ひとくさり／ひとこま
丁字	クローブ
丁抹	デンマーク
丁斧掛	ちょんがけ
丁稚	でっち
丁翁	あけび
丁香	ちょうじ
丁香花	はしどい
丁髷	ちょんまげ
七五三縄	しめなわ
七五三飾り	しめかざり
七夕	たなばた
七寸	みずつき
七星子	むかごにんじん
七種	ななくさ
七葉樹	とち
万寿果	パパイヤ
万年青	おもと
万聖節	ハロウィーン
丈夫	ますらお
三一	さんぴん
三人	みたり
三厄利那	セントヘレナ
三味線	しゃみせん
三和土	たたき
三布	みの
三幅	みの
三年	みとせ
三斑鶉	みふうずら
三枝	さきくさ
三椏	みつまた
三槲	みつがしわ
三歳	みとせ
三毬杖	さぎちょう
三狐神	さぐじ
三白草	はんげしょう
三稜草	みくり
三線	サンシン
三行半	みくだりハン
三角楓	とうかえで
三趾鷗	みつゆびかもめ
三鞭酒	シャンパン
上下	かるめる
上不見桜	うわみずざくら
上声	じょうしょう
上手	じょうず
上枝	ほつえ
上総	かずさ
上達部	かんだちめ
上野	こうずけ
下手	へた
下散	げさん
下枝	しずえ
下火	あこ
下端	さがりは
下総	しもうさ
下襲	したがさね
下財	げさい
下足	げそ
下野	しもつけ
下野草	しもつけそう
下風	おろし
下食日	げじきにち
不丹	ブータン
不倒翁	おきあがりこぼし
不器用	ぶきっちょ
不如帰	ほととぎす
不拘	かかわらず
不束	ふつつか
不来梅	ブレーメン
不生女	うまずめ
不盧多	ブルータス
不知不識	しらずしらず
不知火	しらぬい
不聞座頭	きかずざとう
不見転	みずテン
不貞る	ふてる
且且	かたがつ
世嗣	よつぎ
世帯	しょたい
丙午	ひのえうま
両下	まや
両人	ふたり
両刃	もろは
両面	ふたおもて
中務	なかつかさ
中心	なかご
中稲	なかて
丸魚	すっぽん
丹墨	デンマーク
丹第	ダンテ
丹色	にいろ
丹麦	デンマーク
主人	あるじ
主典	さかん
主基田	すきでん
主殿	とのもり
主殿寮	とのもりょう
主水	もんど
主神	かんざね
主税	ちから
主税寮	ちからのつかさ
主計寮	かずえりょう
主計頭	かずえのかみ
丼礑	どぶかっちり
久留子	くるす
乙姫	おとひめ
乙子	おとご
乙甲	めりかり
乙鳥	つばめ
九万疋	くまびき
九十	ここのそじ
九十九	つくも
九十九折	つづらおり
九十九髪	つくもがみ
九十路	ここのそじ
九面芋	やつがしら
乱波	らっぱ
乳切木	ちぎりぎ
乳柑	くねんぼ
乳母	うば／めのと
乳母日傘	おんばひがさ
乳脹	ちぶくら
乾児	こぶん
乾分	こぶん
乾咳	からせき
乾声	ひごえ
乾柿	ほしがき
乾海鼠	ほしこ
乾涸びる	ひからびる
乾物	ひもの
乾肉	ほしじし
乾草	ほしくさ
乾葉	ひば
乾蒸餅	ビスケット
乾酪	チーズ
乾風	あなじ
乾飯	ほしいい／かれいい
乾魚	ひうお／ほしうお／ひざかな
乾鮭	からざけ
乾鰯	ほしか
了得	さすが
予予	かねがね
予言	かねごと
争で	いかで
二人	ふたり
二十	はたち
二十日	はつか
二十歳	はたち
二十重	はたえ
二十黄雀	きれんじゃく
二合半	こなから
二布	ふたの
二幅	ふたの
二形	ふたなり
二日	ふつか
于嗟	ああ
云云	しかじか
云爾	しかいう
五井梁	ガイアナ
五倍子	ふし
五加	うこぎ
五加木	うこぎ
五十	いそ
五十日	いか
五十路	いそじ
五十雀	ごじゅうから
五十集	いさば
五墓日	ごむにち
五形花	げげばな
五月	さつき
五月晴れ	さつきばれ
五月蠅	さばえ
五月闇	さつきやみ
五月雨	さみだれ
五爪籠	やぶからし
五百	いお
五節	ごせち
五衣	いつつぎぬ
井宿	ちちりぼし
亜剌比亜	アラビア
亜力伯	アルプス
亜墨利加	アメリカ
亜弗利加	アフリカ
亜当	アダム
亜得亜	アドリア
亜拉毘亜	アラビア
亜撒	アーサー
亜歴山	アレキサンダー
亜爾	アール
亜爾吉墨都	アルキメデス
亜爾然丁	アルゼンチン
亜理斯多徳	アリストテレス
亜米利加	アメリカ
亜細亜	アジア
亜馬孫	アマゾン
亡土	もうど
亡状	ムジョウ
亡軀	なきがら
亡骸	なきがら
亢宿	あみぼし
交交	こもごも
交向	まぜむこう
交喙	いすか
交譲木	ゆずりは
人心地	ひとごこち
人状	ひとざま
人長	ひとだけ
人雪崩	ひとなだれ
人面竹	ほていちく
人頽	ひとなだれ
仄仄	ほのぼの
今宵	こよい
今将	いまはた
今年	ことし
今日	きょう
今日日	きょうび
今朝	けさ
今生	こんじょう
今際	いまわ
仏利由私	プリニウス
仏勒里達	フロリダ
仏掌薯	つくねいも
仏甲草	つめれんげ
仏科	フーコー
仏蘭克林	フランクリン
仏蘭西	フランス
仕舞屋	しもたや
他人事	ひとごと
他所	よそ
仙人帽	きぬがさたけ
仙人掌	サボテン
仙人条	いわひも
仙毛欅	いぬぶな
仙蓼	われもこう
仙迷	センチメートル
代指	つまばらみ
代終ね	だいばね
令法	りょうぶ
以丁堡	エディンバラ
以来	このかた
以津真天	いつまで
以為	おもえらく
以色列	イスラエル
仮令	ケリヨウ・たとい
仮名	かな
仮寝	うたたね
仮標	かりしめ
仮漆	ニス
仮面梟	めんふくろう
仰領	のけくび
仲人	なこうど
任那	みまな
伊太利	イタリア
伊曾保	イソップ
伊王	イワン
伊聶謝	エニセイ
伊達	だて
伊達巻	だてまき
伊頓	イートン
伏兎	ぶと
休玆	ヒューズ
伝手	つて
伝馬船	てんません
伯剌西爾	ブラジル
伯林	ベルリン
伯母	おば
伯父	おじ
伯理	ペリー
伯耆	ほうき
伴天連	バテレン
伸す	のす
伺候	さもらい
似う	そぐう
似紫	にせむらさき
似而非	えせ
似非	えせ
但馬	たじま
位封	いふ
低低	ひきひき
住処	すみか
佐拉	ぞら
何処	どこ／いずこ／いずく
何卒	なにとぞ
何奈	いかん
何奴	どいつ
何如	いかん
何所	どこ
何故	なぜ
何方	どちら／どなた／どっち
何時	いつ
何某	なにがし
何等	なんら
何若	いかん
何首烏	つるどくだみ
余戸	あまりべ
余所	よそ
余所見	よそみ
余波	なごり
作物所	つくもどころ
佞人	ねじけびと
佩物	おもの／おびもの
佶屈い	ぎこちない
侍女	まかたち
侍婢	まかたち
侏儒	ひきひと
侘助	わびすけ
供奉	ぐぶ
供笥	くげ
依代	よりしろ
便尼	ペニー
俄国	ロシア
俎板	まないた
俘虜	とりこ
保加利亜	ブルガリア
保合	もちあい
俠気	おとこぎ
信天翁	あほうどり
信楽焼	しがらきやき
信濃	しなの
修二会	しゅにえ
修法	ずほう
修理職	しゅりしき
俱楽部	クラブ
俳優	わざおぎ
俾斯麦	ビスマルク
倉稲魂	うかのみたま
倍士児	バーゼル
倍根	ベーコン
倍良	べら
倒に	さかしまに
借問	しゃもん
倫勃朗	レンブラント
倫敦	ロンドン
倭塔瓦	オタワ
倭文	しず
倶生神	くしょうじん
偃松	はいまつ
停止	チョウジ
健児	こんでい
健駄羅	ガンダーラ
側女	そばめ
側妻	そばめ
側柏	このてがしわ
側次	そばつぎ
側金盞花	ふくじゅそう
偶偶	たまたま
偽瓢虫	てんとうむしだまし
傀儡	くぐつ／でく
傀儡子	くぐつ
傍目	はため
傑里烈遠	ガリレオ
傘松	こうやまき
備後表	びんごおもて
催合	もやい
傴僂	せむし
傾れる	なだれる
傾れ込む	なだれこむ
僂麻質斯	リウマチ
僕射	ぼくや
僧都	ソウズ
元宝草	ほとけのざ
兄矢	はや
兄部	このこうべ
兄鷂	このり
兄鷹	しょう
光一	ぴかいち
光参	きんこ
光桃	つばいもも
克勒巴都拉	クレオパトラ
兎唇	いぐち
兎子草	やぶれがさ
兜櫨樹	のぐるみ
入声	ニッショウ
入徳蘭	ユトランド
入梅	ついり
入水	じゅすい
入爾馬泥亜	ドイツ
入眼	ジュガン
入籠	いれこ
全人	まとうど
全手葉椎	まてばしい
八仙花	あじさい
八入	やしお
八十	やそ
八十路	やそじ
八吉打	バグダッド
八咫	やた
八哈剌因	バーレーン
八尺瓊曲玉	やさかにのまがたま
八岐大蛇	やまたのおろち
八州	やしま
八幡船	ばはんせん
八握	やつか
八方	やも
八束	やつか
八百万	やおよろず
八百屋	やおや
八百長	やおちょう
八節	やふ
八色の姓	やくさのかばね
八衢	やちまた
八角金盤	やつで
八面	やも
公孫樹	いちょう
公斯当丁	コンスタンチン
公方	くぼう
公果	コンゴ
公達	きんだち
公額	コンゴ
公験	くげん
公魚	わかさぎ
六指	むさし
六月菊	みやまよめな
六月雪	はくちょうげ
兵児帯	へこおび
其処	そこ
其処等	そこら
其奴	そいつ
其所	そこ
其方	そなた／そちら
其方此方	そちこち
其方退	そっちのけ
典侍	ないしのすけ
典薬頭	くすりのかみ
内匠	たくみ
内匠寮	たくみづかさ
内外	うちと
内官家	うちつみやけ
内歩	うちぶ
内法	うちのり
内臣	うちつおみ
内舎人	うどねり
内蔵寮	くらりょう／くらづかさ
内障	そこひ
円円	つぶつぶ
円居	まどい
円座	わろうだ
円舞曲	ワルツ
円規	コンパス
冊立	さくりゅう
冠る	かぶる
冠付	かむりづけ
冠卓	かんむりじょく
冠直衣	こうぶりのうし
冬瓜	とうがん
冬眠鼠	やまね
冬葱	わけぎ
冬薔薇	ふゆそうび
冬青	そよご
冷まじ	すさまじ
冷奴	ひややっこ
凄腕	すごうで
凌霄花	のうぜんかずら
凌霄葉蓮	のうぜんはれん
凝乳	クリーム
几褥	テーブルクロス
凡ゆる	あらゆる
凸凹	でこぼこ
凸柑	ぽんかん
出会す	でくわす
出師	すいし
出来	しゅったい
出汁	だし
出生	すいさん
出目是閑	でめぜかん
出石焼	いずしやき
出端	でばな
出雲	いずも
出頰	でづら
刀子	とうす
刀豆	なたまめ
分餅	へぎもち
切処	きれっと
切幣	きりぬさ
切節	きりよ
切籠	きりこ
切麻	きりぬさ
刑部省	ぎょうぶしょう
列卒	せこ
列寧	レーニン
列当	はまうつぼ
列敦士丁	リヒテンシュタイン
初中後	しょっちゅう
初冠	ういこうぶり
初切	しょっきり
初午	はつうま
初心	うぶ
初手水	はつちょうず
初東雲	はつしののめ
判官	じょう
別林郭	ベーリング
利比亜	リビア
利比利亜	リベリア
利篤謨斯	リトマス
利鎌	とがま
利馬	リマ
刳い	えぐい
刳形	くりかた
刳舟	くりふね
刷子	はけ
刷毛	はけ
刹帝利	クシャトリヤ
刺亀虫	さしがめ
刺椿象	さしがめ
刺楸	はりぎり
刺草	いらくさ
刺虫	いらむし
刺蛾	いらが
刺鉄	さすが
刺青	いれずみ
刻刻	ぎざぎざ
剃刀	かみそり
前栽	センザイ
前胡	のだけ
前褌	まえみつ
剖判	ほうはん
剛色斯	カンザス
剣橋	ケンブリッジ
剣魚	ぎんざめ
剥る	へずる
剪刀	はさみ
剪秋羅	せんのう
副寺・副司	ふうす
割符	さいふ
割賦	くばりぶぎょう
力勉める	つとめる
力瘤	ちからこぶ
加之	しかのみならず
加利福尼	カリフォルニア
加刺多	カラット
加加阿	カカオ
加奈陀	カナダ
加密爾列	カミルレ
加州	カリフォルニア
加布爾	カブール
加拉架	カラカス
加拿列	カナリア
加比丹	カピタン
加爾各搭	カルカッタ
加特力	カトリック
加答児	カタル
加臘多	カラット
助太刀	すけだち
助柱	すけ
努努	ゆめゆめ
劬る	いたわる
労き	いたずき
勃労寧	ブラウニング
勃勃	むくむく
勃牙利	ブルガリア
勇魚	いさな
勒布朗	ルブラン
勒魚	しいら
勘事	こうじ
勘解由使	かげゆし
勝鬨	かちどき
勢み	はずみ
勢車	はずみぐるま
勺旁	ショパン
勾欄	てすり
勾玉	まがたま
勿告藻	なのりそ
勿忘草	わすれなぐさ
勿来薬	なこそぐすり
勿来関	なこそのせき
包子	パオズ
包飯	つつみいい
匈牙利	ハンガリー
匕首	あいくち
化粧	けわい
化野	あだしの
化香樹	のぐるみ
北明翰	バーミンガム
北閔	ブレーメン
北風	あなじ・きた
匙笥	かいげ
匣鉢	さや
匹如身	するすみ
区区	まちまち
十二雀	じゅうにから
十八番	おはこ
十六夜	いざよい
十六武蔵	ジュウロクむさし
十大功労	ひいらぎなんてん
十姉妹	じゅうしまつ
十寸鏡	ますかがみ
十日夜	とおかんや
十柱球	ボーリング
十脚	さくらえび
十重二十重	とえはたえ
十露盤	そろばん
千万	ちよろず
千五百秋	ちいほあき
千入	ちしお
千尋	ちひろ
千屈菜	みそはぎ
千根	ちもと
千歳	ちとせ
千種	ちぐさ
千葉山梔子	こくちなし
千金藤	はすのはかずら
升麻	うたかぐさ
半使	ハンス
半月	はにわり
半色	はしたいろ
半被	はっぴ
半辺蓮	みぞかくし
半辺蚶	いたやがい
半銭	きなか
半頭	はつぶり
半首	はつぶり／はつむり
卓別麟	チャップリン
卓子	テーブル
卓球	ピンポン
卓袱台	ちゃぶダイ
南五味子	さねかずら
南京黄櫨	なんきんはぜ
南天燭	なんてん
南旺府	プノンペン
南森	ナンセン
南殿	なでん
南燭	しゃしゃんぼ
南瓜	かぼちゃ
南蛮煙管	なんばんぎせる
南謨	なも
南風	はえ
単寧	タンニン
単皮	たび
単衣	ひとえ
博士	はかせ
博奕	ばくち
博打	ばくち
卜兆	うらかた
卜書	うらぶみ
卮子	くちなし
卯木	うつぎ
印度	インド
印籠決	いんろうじゃくり
危宿	うみやめぼし
厄勒祭亜	ギリシャ
厄日多	エジプト
厄瓜多	エクアドル
厚司	あつし
厚朴	ほおのき
厚皮香	もっこく
厥陰病	けっちんびょう
厳器	からくしげ
去なす	いなす
去声	きょしょう
去年	こぞ
参宿	からすきぼし
又従兄弟	またいとこ
又従姉妹	またいとこ
叉倉	あぜくら
及己	ふたりしずか
友志良賀	ともしらが
友達	ともだち
双ぶ	ならぶ
双六	すごろく
双手	もろて
双瓶梅	にりんそう
双肌	もろはだ
双鸞菊	かぶとぎく
反古	ほご
反吐	へど
反嘴鴫	そりはししぎ
反故	ほご
反歩	たんぶ
反転	くるべき
反閉	へんばい
叔伯特	シューベルト
叔曼	シューマン
叔母	おば
叔父	おじ
叙利亜	シリア
叙里亜	シリア
叢時雨	むらしぐれ
口下手	くちべた
口分田	くぶんでん
口吟む	くちずさむ
口唱	クソウ
口女	くじめ
口惜しい	くやしい
口授	クジュ
口琴	びやぼん
口疾	くちど
口端	くちは
口舌	クゼツ
口許	くちもと
口説く	くどく
口風琴	ハーモニカ
古兵	ふるつわもの
古刃	ふるみ
古弗	コッホ
古矢刺	くじら
古論武士	コロンブス
叩瓮	たたきべ
叩頭虫	ぬかずきむし
只管	ひたすら
召人	めしゅうど／めしうど
可坊	べらぼう
可怕い	おっかない
可惜	あたら
可成	なるべく
可矣	かなり
可辟児	コペルニクス
台子	だいす
台湾鶩	ばりけん
台詞	せりふ
右京職	うきょうしき
右手	めて
右流左止	うるさし
右近左近	うこさこ
吃吃	くすくす
吃逆	しゃっくり
吃驚	びっくり
各各	おのお の
合子草	ごきづる
合標	あいじるし
合歓	ねむのき
合歓木	ねむのき
合決	あいじゃくり
合羽	カッパ
吉丁虫	たまむし
吉事	よごと
吉備奈仔	きびなご
吉左右	きっそう
吉方	えほう
吉言	よごと
同胞	はらから
名告	なのり
名残	なごり
吐綬鶏	しちめんちょう
吐魯蕃	トルファン
向日葵	ひまわり
向股	むかもも
君遷子	しなのがき
否む	いなむ
否否	いやいや
否然	いなぜ
否諾	いなせ
含羞む	はにかむ
含羞草	おじぎそう
吹喜月	ふきづき
吹聴	ふいちょう
吹螺	ほらがい
吹雪	ふぶき
吾亦紅	われもこう
吾妹	わぎも
呂宋	ルソン
呆気者	うつけもの
呉呂茶	クロアチア
呉服	くれはとり
呉桃	くるみ
呉竹	くれたけ
呉織	くれはとり
呉茱萸	からはじかみ
呉藍	くれない
告天子	ひばり
告文	コウモン
周章狼狽	どぎまぎ・あわてふためき
周防	すおう
呪師	ずし
呪禁	じゅごん
味漬	あまづけ
味酒	うまさけ
呷呷	ぐいぐい
和人	シャモ
和地関	バチカン
和妙	にきたえ
和寧	カラコルム
和尚菜	のぶき
和布	わかめ
和布刈	めかり
和布蕪	めかぶら
和幣	にきて
和御魂	にきみたま
和手	にこで
和林	カラコルム
和栲	にきたえ
和楽	からく
和毛	にこげ
和泉	いずみ
和稲	にしきね
和膚	にきはだ
和草	にこぐさ
和蘭	オランダ
和蘭陀	オランダ
和郎	わろ
和魂	にきみたま
咲華	さっか
品字梅	やつぶさうめ
品部	ともべ
哇的麻剌	グアテマラ
哈勒法	ハリファックス
哈府	ハバロフスク
哈爾浜	ハルビン
哈爾賓	ハルビン
哈維	ハワイ
哈馬哈	オマハ
哥倫比亜	コロンビア
哥力米	クリミア
哥塞牙	コルシカ
哥天百格	グーテンベルグ
哥摩羅	コモロ
哥木哈牙	コペンハーゲン
哥本哈干	コペンハーゲン
哥羅尼	ケルン
哨吶	チャルメラ
哲立科	ジェリコー
唐匣	からくしげ
唐土	もろこし
唐木香	もっこう
唐棣花	はねず
唐櫃	からびつ
唐芥子	トウがらシ
唐黍	もろこし
唖蝉	おしぜみ
唯今	ただいま
唯唯	へいへい
唱聞師	しょうもじ
啄木鳥	きつつき／けら
商人	あきんど
商陸	やまごぼう
問荊	すぎな
喀喀	おめおめ
善知鳥	うとう
善那	ジェンナー
喇嘛教	ラマキョウ
喋喋	べらべら
喜蛛	てながぐも
喜馬拉	ヒマラヤ
喜馬拉雅	ヒマラヤ
喝火	かっこ
喞筒	ポンプ
喫驚	びっくり
嗚呼	ああ
嘉魚	いわな
嘔吐く	えずく
嘴太鴉	はしぶとがらす
器楽曲	インストルメンタル
噯	あつかい
噯気	おくび
噴雪花	ゆきやなぎ
嚇法拿	ハバナ
囃子	はやし
囈語	うわごと
囚人	めしゅうど
囚獄	ひとや
四十雀	しじゅうから
四布	よの
四幅	よの
四斗樽	しとだる
四方	よも
四方山	よもやま
四方手	しおで
四照花	やまぼうし
四葩	よひら
四阿	あずまや
回回教	フイフイキョウ
回青橙	だいだい
因幡	いなば
団居	まどい
団扇	うちわ
図書寮	ずしょりょう
固唾	かたず
固関	こげん
国栖	くず
国覓	くにまぎ
国許	くにもと
国質	くにじち
国風	くにぶり
土公神	どくじん
土器	かわらけ
土塊	つちくれ
土師	はじ
土師器	はじき
土常山	あまちゃ
土弥尼加	ドミニカ
土当帰	のだけ／うど
土木通	つちあけび
土棲蜂	つちすがり
土産	みやげ
土竜	もぐら
土筆	つくし
土耳古	トルコ
土芋	ほど
土荊芥	ありたそう
土蜂	ゆするばち
土通草	つちあけび
圧状	おうじょう
圧酢	おしずし
圧面	べしみ
在処	ありか
在得	チャド
在所	ありか
地吹雪	ジふぶき
地梨	くさぼけ
地楡	われもこう
地潜	じむぐり
地祇	くにつかみ
地経	じだて
地緯	じよこ
地胆	つちはんみょう
地花菜	きんれいか
地蛍	つちぼたる
地血	あかね
地衣苔	うめのきごけ
地車祭	だんじりまつり
地銭	ぜにごけ
地錦	つた
地革利斯	チグリス
地革里斯	チグリス
坩堝	るつぼ
坪移	つぼなおし
垂とする	なんなん
垂水	たるみ
垂氷	たるひ
垂領	たりくび
垂髪	すべらかし
型録	カタログ
垢穢	くえ
垣内	かいと
垣衣	しのぶぐさ
埃及	エジプト
埃茸	ほこりたけ
埋大根	いけだいこ
埋炭	いけずみ
埋葬虫	しでむし
埴猪口	へなちょこ
埴瓮	はにべ
埴生	はにゅう
埴破	はんなり
基米突	キロメートル
基隆	キールン
堂頭	どうちょう
堅塩	きたし
堅磐	かきわ
堅魚	かつお
堅魚木	かつおぎ
堪察加	カムチャツカ
堰杙	いぐい
報える	こたえる
報達	バグダッド
塊芋	ほど
塔主・塔司	タッス
塗師	ぬし
塗籠	ぬりごめ
塘蒿	セロリ
塞丙牙	セネガル
塞爾維	セルビア
塞班	サイパン
塞納	セーヌ
塞耳比	セルビア
塩汁	しょっつる
塩膚木	ぬるで
塵手水	ちりちょうず
塵芥虫	ごみむし
墨西哥	メキシコ
墨魚	いか
墾道	はりみち
壁宿	なまめぼし
壁虎	やもり
壁蝨	だに
士班牙	スペイン
士篤恒	ストックホルム
壬生菜	みぶな
壱岐	いき
壱越調	いちこつチョウ
売僧	マイス
売女	ばいた
売子木	さんたんか
壺菫	つぼすみれ
変倫諾爾	イリノイ
変色蜥蜴	カメレオン
夏初月	なつはづき
夏書	げかき
夏籠	けごもり
夏蚕	なつご
夕星	ゆうずつ
夕貌	ゆうがお
夕陽	ゆうひ
外国	とつくに
外山	とやま
外持	ほまち
外方	そっぽ
外様	とざま
外法	そとのり
外記	げき
外障	うわひ
多倫多	トロント
多島海	エーゲかい
多悩	ドナウ
多聞天	たもんてん
多遅	たじ
多霊	トリノ
夜半	よわ
夜咄	よばなし
夜尿	よばり
夜業	よなべ
夜発	やほつ
夜直	よたた
夜臼式	ゆうすしき
夜興引	よこびき
夢現	ゆめうつつ
夥多	あまた
大世帯	おおジョタイ
大人	うし／ おとな
大兄	おおえ
大凡	おおよそ
大刀	たち
大十社	タキトゥス
大口魚	たら
大和	やまと
大和撫子	やまとなでしこ
大和歌	やまとうた
大和魂	やまとだましい
大塊	おおぐれ
大夫	たゆう
大形	おおぎょう
大御灯	おおみあかし
大戟	たかとうだい
大旦	おおあした
大晦	おおつごもり
大晦日	おおみそか
大晩菜	おばんざい
大曲	おおわだ
大殯	おおあらき
大殿	おとど
大殿油	おおとなぶら
大水萍	ほていあおい
大炊	おおい
大炊寮	おおいリョウ
大猩猩	ゴリラ
大砌	おおみぎり
大祓	おおはらえ
大童	おおわらわ
大臣	おとど
大芥菜	たかな
大茴香	アニス
大荒城	おおあらき
大葉藻	あまも
大蒜	にんにく
大蚊	ががんぼ
大蛇	おろち
大衍暦	たいえんれき
大角	はらのふえ
大角草	いささぐさ
大角豆	ささげ
大豆粕	まめかす
大連	おおむらじ
大鉈	おおなた
大鋸屑	おがくず
大闢	ダビデ
大陰神	だいおんじん
大雪山	ヒマラヤ
大音声	だいおんじょう
大風	おおぶり
大馬士革	ダマスカス
大鮃	おひょう
大鯊	だぼはぜ
大鷺	だいさぎ
大鼓	おおかわ
天一神	なかがみ
天井桟敷	テンジョウさじき
天倪	あまがつ
天児	あまがつ
天名地鎮	あないち
天名精	やぶたばこ
天地	あめつち
天女花	おおやまれんげ
天幕	テント
天晴	あっぱれ
天柱	ちりけ
天牛	かみきりむし
天皇	すめらみこと
天社蛾	しゃちほこが
天竺牡丹	ダリア
天糸瓜	へちま
天蚕	やままゆ
天蚕糸	てぐす
天蛾	すずめが
天道	あまじ
天青地白	ちちこぐさ
天魚	あまご
天鵝絨	ビロード
天麻	おにのやがら
天鼠	こうもり
天鼠失	くすね
太兆	ふとまに
太刀	たち
太刀奪	たちばい
太刀打ち	たちうち
太刀風	たちかぜ
太刀魚	たちうお
太占	ふとまに
太夫	たゆう
太宰権帥	だざいのごんのそち
太山樒	みやましきみ
太布	たふ
太平簫	ちゃるめら
太政官	だじょうかん
太棹	ふとざお
太白神	ひとひめぐり
太肉	ふとりじし
太藺	ふとい
夫夫	それぞれ
夫婦	めおと
夫籠	つまごみ
夫羅凌斯	フィレンツェ
失声	ひごえ
夷守	ひなもり
夷曲	ひなぶり
奇に	あやに
奈何	いかん
奈翁	ナポレオン
奎宿	とかきぼし
奏鳴曲	ソナタ
契情	けいせい
奠稲	くましね
奥克蘭	オークランド
女喜志古	メキシコ
女夫	みょうと
女宿	うるきぼし
女将	おかみ
女形	おやま
女方（遺跡）	おかた
女日芝	めひしば
女無天	ミント
女留保論	メルボルン
女真	くまのみずき
女衒	ぜげん
女貞	ねずみもち
女郎花	おみなえし
女郎蜘蛛	じょろうぐも
女青	へくそかずら
奴原	やつばら
奴国	なのくに
如件	くだんのごとし
如何	いかが／いかん／どう
如何児	いかなご
如何様	いかさま
如何様師	いかさまシ
如何物食い	いかものぐい
如去	にょこ
如斯	かくのごとし
如月	きさらぎ
如此	かくのごとし
如雨露	ジョウロ
如露	ジョウロ
妄榧	もみ
妓夫	ぎゅう
妹兄	いもせ
妹背	いもせ
妻夫	めおと
妻子	めこ
妻敵	めがたき
妾馬	めかうま
姉女	せなじょ
姉妹	きょうだい
姉弟	きょうだい
委す	まかす
委内瑞拉	ベネズエラ
委内瑞辣	ベネズエラ
委曲	つばら
姥百合	うばゆり
姨捨山	おばすてやま
姪騫	ディケンズ
姫昔艾	ひめむかしよもぎ
姫莎草	ひめくぐ
威内斯	ベニス
威霊仙	くがいそう
娘子郎四	おみなえし
婁宿	たたらぼし
婆羅	ボルネオ
婆羅的	バルチック
婆芹	おばぜり
婚星	よばいぼし
婚礼菓子	ウエディングケーキ
媒鳥	おとり
媾曳	あいびき
嫁鳥	とつぎどり
嫡妻	むかいめ
嫡嫡	ちきちゃき
嫩	ふたば
嬉嬉	いそいそ
嬋媛	おそよか
嬌柳	たおやなぎ
嬢はん	いとはん
嬰児	みどりご
子生婦	こんぶ
子規	ほととぎす
子負着	こよぎ
孑孑	ぼうふら
孑孒	ぼうふら
孔徳	コント
孔球	ゴルフ
孕女	うぶめ
存処	ありか
孛烈児	ポーランド
孛露	ペルー
孟加拉	バングラデシュ・ベンガル
孟徳斯鳩	モンテスキュー
孟禄	モンロー
孟買	ボンベイ
孤児	みなしご
学舎	まなびや
宇瓦	のきがわら
守宮	やもり
守宮神	すくじん
守瓜	うりばえ
安土府	アントワープ
安得仙	アンデルセン
安房	あわ
安特堤	アムステルダム
安的児孫	アンデルセン
安石榴	ざくろ
安芸	あき
完骨	みみせせ／せせ
宗段	スーダン
宛行	あてがい
宛行扶持	あてがいブチ
宜候	ようそろ
実に	げに
実生	みしょう
実葛	さねかずら
客人	まろうど
客実	まろうどざね
室咲	むろざき
室宿	はついぼし
宵宮	よみや
家司	けいし
家壁蝨	いえだに
家猪	ぶた
家船	えぶね
家苞	いえづと
家部	やかべ
家鴨	あひる
宿星菜	ぬまとらのお
宿曜	すくよう
宿直	とのい
宿花	よみはな
宿酔	ふつかよい
宿鮎	さびあゆ
寄人	よりゅうど
寄居虫	やどかり
寄席	よせ
寄方	よるべ
寄生木	やどりぎ
寄生蜂	やどりばち
密事	みそかごと
密執安	ミシガン
密士失比	ミシシッピ
密夫	まおとこ
密密	ひそひそ
密河	ミシシッピ
密男	まおとこ
富籤	とみくじ
富貴草	ふっきそう
寒復習	かんざらい
寒晒粉	かんざらしこ
寒苺	ふゆいちご
寒蟬	つくつくぼうし
寝心地	ねごこち
寝穢い	いぎたない
寝聡い	いざとい
察母阿	サモア
寡婦	やもめ
寡男	やもお
寧楽	なら
寮国	ラオス
寸半	きなか
寸寸	ずたずた
寸白	すばく
寸莎	すさ
対う	むかう
対屋	たいのや
対馬	つしま
寿光木	さわぐるみ
寿府	ジュネーブ
寿歌	ほぎうた
寿留女	するめ
寿詞	よごと
封土	ポンド
封度	ポンド
専女	とうめ
射干	ひおうぎ
射干玉	ぬばたま
射翳	まぶし
将又	はたまた
尉鶲	じょうびたき
小傘	こがらかさ
小咄	こばなし
小啄木鳥	こげら
小国鶏	しょうこく
小夜	さよ
小夜曲	セレナーデ
小太刀	こだち
小女子	こうなご
小尉	こじょう
小巣鳥	すずめのえんどう
小巾	こぎん
小忌	おみ
小忌衣	おみごろも
小手毬	こでまり
小斎	おみ
小春日和	こはるびより
小晦日	こつごもり
小札	こざね
小櫱	めぎ
小止み無し	おやみなし
小水葱	こなぎ
小波	さざなみ
小火	ぼや
小灰蝶	しじみちょう
小瓠	こふくべ
小百合	さゆり
小皺	こじわ
小督	こごう
小童	こわっぱ
小端釘	こばくぎ
小竹	ささ
小筒	ささえ
小網	さで
小腹	このかみ
小舅	こじゅうと
小舌	ひこ
小茄子	こなすび
小角	くだ のふえ
小豆	あずき
小豆粥	あずきがゆ
小豆餡	あずきアン
小連翹	おとぎりそう
小酒	リキュール
小鉤	こはぜ
小陵鳥	こがら
小雀	こがら
小雉尾草	たちしのぶ
小魚	いさな
小鮑	とこぶし
小鰭	こはだ
少女	おとめ
少輔	しょう
尚侍	ないしのかみ
尚更	なおさら
尨毛	むくげ
尨犬	むくいぬ
就中	なかんずく
尸所	かばねどころ
尸童	よりまし
尸者	ものまさ
尺蠖	おぎむし
尻尾	しっぽ
尻当	いしきあて
尻籠	しこ
尻繫	しりがい
尻腰	しっこし
尻臀	しりこぶた
尼亜吉拉	ナイアガラ
尼哇達	ネバダ
尼喀拉瓜	ニカラグア
尼徳蘭	オランダ
尼格来	にこらい
尼羅	ナイル
尼馬	ネロ
尽れる	すがれる
尾宿	あしたれぼし
尾能	きりのう
尿筒	しとづつ
尿袋	ゆばりぶくろ
屁屎葛	へくそかずら
屁放虫	へひりむし
屁糞葛	へくそかずら
居囃子	いばやし
居坐機	いざりばた
居士	こじ
居士衣	こじエ
居心地	いごこち
居曲	いぐせ
居比路	キプロス
居礼	キュリー
居里	キュリー
屈背	くぐせ
屍櫃	からひつ
属鏤	ショクル
屠格涅夫	ツルゲーネフ
屢屢	しばしば
屢雨	しばあめ
屯倉	みやけ
屯家	みやけ
屯田	みた
屯蹇	ちゅんけん
山 姥	やまんば
山丹	ひめゆり
山処	やまと
山原水鶏	やんばるくいな
山女	あけび・やまめ
山小菜	ほたるぶくろ
山岨	やまそわ
山峡	やまかい
山慈姑	あまな
山栄樹	かんぼく
山桜桃	ゆすらうめ
山梅花	ばいかうつぎ
山梔子	くちなし
山梗葉	さわぎきょう
山楝蛇	やまかがし
山槭樹	やまもみじ
山毛欅	ぶな
山水屏風	せんずいびょうぶ
山珊瑚	つちあけび
山疵	やまきず
山白竹	くまざさ
山石榴	のぼたん
山礬	あくしば・じんちょうげ
山祇	やまつみ
山神	やまつみ
山竹	めだけ
山羊	やぎ
山羊鬚	やぎひげ
山翡翠	やませみ
山背	やましろ
山胡椒	やまこうばし
山脈	やまなみ
山膚	やまはだ
山芹菜	なべな
山苞	やまづと
山茶	つばき
山茶花	さざんか
山葵	わさび
山蒜	のびる
山藤	くまやなぎ
山蘭	ひよどりばな
山蘿蔔	まつむしそう
山襞	やまひだ
山賤	やまがつ
山車	だし
山間	やまあい
山雀	やまがら
山香	やまこうばし
山魚狗	やませみ
山鷸	やましぎ
山黒豆	のささげ
山鼠	やまね
岌朴敦	ケープタウン
岐嶷	いこよか
岐路	えだみち
岨清水	そばしみず
岩座	いわくら
岩曲	いわわだ
岩棠子	いわなし
岩清水	いわしみず
岩煙草	いわたばこ
岩魚	いわな
岳樺	たけかんば
峩羅斯	ロシア
島田髷	しまだまげ／しまだわげ
崑崙八仙	ころばせ
崩崖	あず
巌桂	きんもくせい
川原	かわら
川太郎	がたろ
川床	ゆか
川曲	かわわ
川獺	かわうそ
川薑	かわはじかみ
川蜷	かわにな
川螻蛄	かわげら
川面	かわも
川骨	こうほね
左京職	さきょうしき
左右	とかく
左手	ゆんで
左義長	どんど
左褄	ひだりづま
左見右見	とみこうみ
巧婦鳥	みそさざい
巨頭鯨	ごんどうくじら
巫女	みこ
巫山戯る	ふざける
巫鳥	しとど
差し支える	さしつかえる
巴佩道斯	バルバドス
巴勒	パリ
巴勒斯坦	パレスチナ
巴勒斯旦	パレスチナ
巴哈	バッハ
巴基斯担	パキスタン
巴塞洛納	バルセロナ
巴塞羅	バルセロナ
巴多呉仁屋	パタゴニア
巴奈馬	パナマ
巴巴多	バルバドス
巴巴突	バルバドス
巴布	パップ
巴拉加	プラハ
巴拉圭	パラグアイ
巴斯	パリ
巴林	バーレーン
巴格達都	バグダッド
巴比倫	バビロン
巴波那	ハバナ
巴爾幹	バルカン
巴爾札克	バルザック
巴社	ペルシア
巴豆	はず
巴達維亜	ジャカルタ
巴里	パリ
巴里斯班	ブリスベン
巴馬	パルマ
巴黎	パリ
巻丹	おにゆり
巻子	へそ
巻柏	いわひば
巻繊	ケンチン
巻耳	おなもみ／みみなぐさ
巻雲	ケンウン
巾子	こじ
巾子形	こじかた
市俄古	シカゴ
布刺謨玆	ブラームス
布剌度	ぷらとん
布哇	ハワイ
布地	きれじ
布海苔	ふのり
布衣	ホイ
布袋焼	ふないやき
布袴	ホウコ
希伯来	ヘブライ
希求	けく
希臘	ギリシャ
帖紙	たとうがみ
帚木	ほうきぎ・ははきぎ
帛琉	パラオ
師兄	すひん
師走	しわす
席労	シラー
席勒爾	シラー
帯下	こしけ
帯刀	たちはき
帯魚	たちうお
帷子	かたびら
常歩	なみあし
常滑焼	とこなめやき
常盤	ときわ
常磐	ときわ
常磐木	ときわぎ
常磐津	ときわず
常磐色	ときわいろ
常磐草	かんあおい
常陸	ひたち
帽額	もこう
幢幢	とうとう
幣帛	にきて
幫間	たいこもち
干徳	カント
干捏底格子	コネチカット
干支	えと
干賽斯	カンザス
干飯	ほしいい
平城	なら
平声	ひょうしょう
平太	へいだ
平柳	ペルー
平江帯	ひごたい
平産樹	こやすのき
平等焼	たいらやき
平絎	ひらぐけ
年三	ねそう
年星	ねそう
年次	としなみ
年甲斐	としがい
年魚	あゆ
幸先	さいさき
幸魂	さきみたま
幹竹	からたけ
幼気	いたいけ
幼発拉的	ユーフラテス
幾人	いくたり
幾何	いくばく
幾年	いくとせ
幾許	いくばく
床框	とこがまち
底土	しはに
底翳	そこひ
店子	たなこ
店屋物	てんやもの
度	めもり
度会神道	わたらいしんとう
度度	よりより
度強い	どぎつい
度爾挌	トルコ
庫侖	クーロン
庭球	テニス
庵室	あぜち
庶妹	ままいも
廂間	ひあわい
廈門	アモイ
廉廉	かどかど
延う	はう
延根	はいね
延縄	はえなわ
建蘭	するがらん
弁別	わいだめ
弓弭	ゆはず
弓殻	ゆがら
弔上げ	といあげ
引剥	ひはぎ
引板	ひた
引艾	ひきよもぎ
引鉄	ひきがね
弗篤	フィート
弗蘭哥林	フランクリン
弟那瑪爾加	デンマーク
弟鷹	だい
弥の明後日	やのあさって
弥児頓	ミルトン
弥列	ミレー
弥加耶児	ミカエル
弥弥	いよいよ
弥拉波	ミラボー
弥撒	ミサ
弥栄	いやさか
弥猛	やたけ
弥生	やよい
弥生土器	やよいドキ
弥終	いやはて
弧光灯	アークトウ
弭巻	はずまき
弱檜	さわら
弱法師	よろぼうし
弱竹	なよたけ
張伯倫	チェンバレン
張宿	ちりこぼし
強盗頭巾	がんどうズキン
強者	つわもの
強請	ゆすり／ねだり
弾機	ばね
当年鴫	とうねん
当所	あてど
当薬	せんぶり
形姿	なりかたち
形振り	なりふり
形貌	なりかたち
彩絵	だみえ
彭里	バリ
影供	えいぐ
影向	ようごう
影護い	うしろいめたい
影青	いんちん
役行者	えんのぎょうじゃ
彼処	あそこ
彼奴	あいつ
彼所	あそこ
彼方	あちら／かなた
彼方此方	あちこち
彼是	あれこれ
彼此	あれこれ
往亡日	おうもうにち
征	しちょう
征矢	そや
征箭	そや
径山寺味噌	きんざんじみそ
後事	しりゅうごと
後妻	うわなり
後志	しりべし
後方	しりえ
後朝	きぬぎぬ
後角	うしろずみ
後輪	しずわ
徐ら	やおら
徒事	あだごと／ただごと
徒人	あだびと
徒口	むだぐち
徒歩	かち
徒然	つれづれ
徒者	ただもの
徒花	あだばな
徒骨	むだぼね
従兄弟	いとこ
従姉妹	いとこ
従祖母	おおおば
従祖父	おおおじ
従神	とものかみ
従者	ずさ
得撒	テキサス
得撫島	ウルップトウ
得撫草	うるっぷそう
御上	おかみ
御世	みよ
御中	おなか
御九日	おくにち
御亭	ごて
御付	おつけ
御代	みよ
御会式	おえしき
御佩刀	みはかし
御内儀	おかみ
御刀代	みとしろ
御哭	みね
御子	みこ
御子突	オホーツク
御巡りさん	おまわりさん
御巫	みかんこ
御幸	みゆき
御強	おこわ
御影供	みえいく
御御籤	おみくじ
御手洗	みたらし
御数	おかず
御暇	おいとま
御殿	みあらか
御母様	おたあさま
御汁	おつけ
御河童	おかっぱ
御法	みのり
御洒落	おしゃれ
御火焼	おほたき
御灯	みあかし
御灯明	みあかし
御父様	おもうさま
御祓	おはらい
御神籤	おみくじ
御稜威	みいつ
御粧	おめかし
御統	みすまる
御膳	おもの
御舎	みあらか
御菜	おかず
御菩薩焼	みぞろやき
御薪	みかまぎ
御虎子	おまる
御衣	おんぞ／みけし
御許	おもと／みもと
御酒	みき
御門	みかど
御降	おさがり
御霊	みたま
御頭	おつむ
御食	みけ
御館	みたち
御饌	みけ
御首	みぐし
御髪	おぐし
御魂	みたま
復水	おちみず
微温	ぬるま
微温湯	ぬるまゆ
微酔	ほろよい
微風	そよかぜ
徳拉克洛亜	ドラクロア
徳雷新	ドロイゼン
心労い	しんどい
心地	ここち
心太	ところてん
心宿	なかごぼし
心延	こころばえ
心算	つもり
心耳	しんに
必里尼斯	ピレネー
忌瓮	いわいべ
忍冬	すいかずら
忍辱	ニンニク
忠実	まめ
忽布	ホップ
忽必烈	フビライ
怏怏	くさくさ
怕痒樹	さるすべり
怖怖	おどおど
怖気	おじけ／おぞけ
怠武林	ダブリン
急度	きっと
急焼	きびしょ
怪士	あやかし
怪鴟	よたか
恐恐	こわごわ
恐惶	あなかしこ
恒不爾革	ハンブルク
恒河	ガンジス
恙虫	つつがむし
恟恟	びくびく
恩格爾	エンゲルス
恩賚	みたまのふゆ
恩頼	みたまのふゆ
恭仁京	くにきょう
恭敬	くぎょう
恭菜	ふだんそう
息吹	いぶき
息嘯	おきそ
息子	むすこ
息長鳥	しながどり
恵特曼	ホイットマン
恵馬遜	エマーソン
悄悄	しおしお
悦加的俚拿	エカテリナ
悪怯れる	わるびれる
悪戯	いたずら
悪毒い	あくどい
悪阻	つわり
悲喜交交	ヒキこもごも
悴人	かせにん
悴侍	かせざむらい
悴枝	かせえだ
惚気	のろけ
惟神	かんながら
惣暗	つつくら
想菰	まいたけ
惹爾日亜	ジョージア
惹耳日亜	ジョージア
愈愈	いよいよ
意気地	いくじ
愛い	うい
愛倫	アイルランド
愛因斯坦	アインシュタイン
愛娘	まなむすめ
愛撒倫	アイスランド
愛沙尼亜	エストニア
愛発関	あらちのせき
愛蘭	アイルランド
愛迪生	エジソン
感ける	かまける
慈姑	くわい
慈鳥	からす
態態	わざわざ
慕士頓	ボストン
慕尼克	ミュンヘン
慳勃爾土	フンボルト
憑代	よりしろ
憑坐	よりまし
憑子	たのもし
憤憤	ぶりぶり
懐香	くれのおも
懸想	けそう
懸鉤子	きいちご
懸魚	げぎょ
懼懼	おずおず
戈壁	ゴビ
戌亥	いぬい
成吉思汗	チンギスハン
我等	われら
戦戦	そよそよ・わなわな
戯しい	あじゃらしい
戯事	ざれごと
戯作	げさく
戯奴	わけ
戯射	さいだて
戯歌	ざれうた
戯言	たわごと／ざれごと
戴勝	やつがしら
房宿	そいぼし
所以	ゆえん
所在	あらゆる
所有	あらゆる
所為	せい
所縁	ゆかり
所謂	いわゆる
所非	ソフィア
扁柏	ひのき
扁桃	アーモンド
扁爪	ひらづめ
扁虫	ひらむし
扁螺	きさご
手実	てまめ
手序	てついで
手底	たなそこ
手弱女	たおやめ
手強い	てごわい
手忠実	てまめ
手懐ける	てなずける
手房	たぶさ
手抉	たくじり
手折る	たおる
手摩乳	てなずち
手斧	ちょうな
手枷	てかせ
手柑	シトロン
手段	てだて
手毬	てまり
手毬唄	てまりうた
手水	ちょうず
手水鉢	ちょうずバチ
手無	たなし
手玩	てまもり
手番	てつがい
手疵	てきず
手結	てつがい
手練	てだれ
手繦	たすき
手腓	たこむら
手許	てもと
手風琴	アコーディオン
打	ダース
打乱筥	うちみだりのはこ
打球	ゴルフ
打眠	ためん
払田柵	ほったのき
托洛斯基	トロツキー
托胎虫	なめくじ
扛秤	ちきり
扶芳藤	つるまさき
把手	とって
把理斯	パリ
抑抑	そもそも
抔恩	ベルン
投球	ボーリング
投網	とあみ
投胡	あないち
折ぐ	へぐ
折和甫	チェーホフ
折敷	おしき
折板	へぎいた
抛銀	なげがね
択捉	えとろふ
披鍼	はばり
抱瓶	だちびん
抹額	まっこう
押書	おっしょ
抽斗	ひきだし
担桶	たご
拉不臘多	ラブラドル
拉巴拉他	ラプラタ
拉白礼	ラブレー
拉薩	ラサ
拍手	かしわで
拍板	びんざさら
拘う	かかずらう
拝倫	バイロン
拝力	バリ
拝所	うがんじゅ
拳螺	さざえ
拳闘	ボクシング
拶双魚	さっぱ
拿林雀	カナリア
拿翁	ナポレオン
持子	もつご
指値	さしね
指切	ゆいきり
指焼草	さしもぐさ
指艾	さしもぐさ
指貫	さしぬき
按察	あぜち
按察使	あぜち
按針	あんじん
挙尾虫	しりあげむし
挙母焼	ころもやき
挙銭	ごぜに
挽家	ひきや
捏巴爾	ネパール
捕まる	とらまる
捨て台詞	すてぜりふ
捩 子	ねじ
捩摺	もじずり
捩花	ねじばな
捷い	はしこい
捷克	チェコ
捺く	つく
捻くる	ひねくる
捻子	ねじ
掃羅們	ソロモン
掃部	かもん
掌侍	ないしのじょう
掌酒	さかびと
掏児	すり
掏摸	すり
排球	バレーボール
排草香	くわみどり
掘串	ふくし
掛絡	から
掛羅	から
掛落	から
掛詞	かけことば
探湯	くかたち
接ぐ	はぐ
接続草	すぎな
接骨木	にわとこ
掻上匣	かかげのはこ
掻掘	かいぼり
掻燈	かいともし
提げる	さげる
提子	ひさげ
提琴	バイオリン
提重	さげじゅう
揚げ雲雀	あげひばり
揚簀戸	あげすど
搗布	かじめ
搗栗	かちぐり
搾滓	しめかす
搾菜	ザーサイ
摂腰	せひえ
摘入	つみれ
摩洛哥	モロッコ
摩納哥	モナコ
摩西	モーゼ
摩賛俾克	モザンビーク
撒児沙	サルサ
撒哈拉	サハラ
撒爾沙	サルサ
撒馬児干	サマルカンド
撓塩	いためじお
撚る	ひねる
撞球	たまつき・ビリヤード
撥条	ぜんまい
播磨	はりま
撲斯東	ボストン
擬作	あてがい
擬宝珠	ぎぼし／ぎぼうし
擬物	まがいもの
擬蟻	ありもどき
擬蠍	かにむし
擺倫	バイロン
攣	てなえ
改羅	カイロ
放下す	ほかす
放十徳	はなちじっとく
放屁虫	へひりむし
放髻	はなちもとどり
政所	まんどころ
故郷	ふるさと
故里	ふるさと
敏捷い	はしこい
敏耳	とみみ
救世	くせ
敗荷	やれはす
敗醬	おとこえし
散切物	ざんぎりもの
散西把	ザンジバル
散銭	ばらせん
数多	あまた
数奇屋	すきや
数寄屋	すきや
数数	しばしば
数珠	じゅず
数珠玉	じゅずだま
敵娼	あいかた
文山賊	ふみやまだち
文机	ふづくえ
文珠蘭	はまゆう
文目	あやめ
文相撲	ふずもう
文章博士	モンジョウはかせ
文筥	ふばこ／ふみばこ
文色	あいろ
文身	いれずみ
斉斉哈爾	チチハル
斎串	いぐし
斎人	いわいびと
斎垣	いがき
斎場	ゆにわ
斎子	いむこ
斎庭	ゆにわ
斎瓮	いわいべ
斎甕物	ゆかもの
斎種	ゆだね
斎肌帯	ゆはだおび
斎蔵	いみくら
斎食	とき
斐希特	フィヒテ
斑杖	まむしぐさ
斑気	むらき
斑濃	むらご
斑葉	いさは
斑蛛	じょろうぐも
斑雪	はだれゆき
斑霧	むらぎり
斑馬	しまうま
斑鳩	いかる／いかるが
斗	とます
斗宿	ひきつぼし
斗組	ますぐみ
斜子織	ななこおり
斥候	うかみ
断雲	ちぎれぐも
斯密乃雑	スピノザ
斯拉仏克	スロバキア
斯程	かほど
斯維弗的	スイフト
斯賓塞	スペンサー
斯辺瑣	スペンサー
斯通達爾	スタンダール
斯達林	スターリン
新嘉坡	シンガポール
新墨是可	ニューメキシコ
新墾	にいばり・あらき
新墾田	あらきだ
新治	にいばり
新湯	さらゆ
新発意	しんぼち
新羅	しらぎ
新西蘭	ニュージーランド
方人	かたうど
方便	たつき
方済各	ザビエル
方舟	はこぶね
方頭魚	かながしら
旁旁	かたがた
旅籠	はたご
旋毛	つむじ
旋網	まきあみ
旋花	ひるがお
旋覆花	おぐるま
旋風	つむじかぜ
旌節花	きぶし
旗標	はたじるし
旗魚	かじき
既得	キト
日保ち	ひもち
日向	ひなた／ひゅうが
日和	ひより
日和る	ひよる
日和見	ひよりみ
日嗣	ひつぎ
日女	ひるめ
日巴拉太	ジブラルタル
日次	ひなみ
日済	ひなし
日照雨	そばえ
日置流	へきリュウ
日耳曼	ドイツ
日雀	ひがら
日霊	ひるめ
旧年	ふるとし
旨煮	うまに
早乙女	さおとめ
早少女	さおとめ
早桃	さもも
早生	わせ
早稲	わせ
早稲月	さいねづき
早終演	はやばね
早緑月	さみどりづき
早花咲月	さばなさづき
早苗	さなえ
早苗饗	さなぶり
早鮓	はやずし
早鮨	はやずし
旱芹	パセリ
旱芹菜	パセリ
明か	さやか
明後日	あさって
明日	あす／あした
明明後日	しあさって
明白	あからさま
明衣	あかは
昏昏	うとうと
易利薩伯	エリザベス
易卜生	イブセン
易易	やすやす
星宿	ほとおりぼし
星港	シンガポール
星鰈	ほしがれい
映日果	いちじく
春告鳥	うぐいす
春宮	とうぐう
春疾風	はるはやて
春蚕	はるご
昨夜	ゆうべ
昨日	きのう
昭南	シンガポール
是界	ぜがい
昴宿	すばるぼし
昼餉	ひるげ
時令	シリング
時化	しけ
時計	とけい
時辰鵲	カナリア
時雨	しぐれ
時雨煮	しぐれに
時鳥	ほととぎす
晃晃	きらきら
晒布	さらし
晦日	みそか／つごもり
晨鐘	じんじょう
晨鴨	しのりがも
晩生	おくて
晩稲	おくて
晩霜	おそじも
晩香坡	バンクーバー
普納塞利斯	ブエノスアイレス
普魯西	プロシア
景仰	けいこう
景天	べんけいそう
景色	けしき
景迹	きょうじゃく
智利	チリ
暖寮	ノンリョウ
暗争	だんまり
暗暗	ぐずぐず
暗闘	だんまり
暮新月	くれしづき
暴風	あかしかぜ
暹羅	シャム
曇華	だんどく
曠野	あらの
曲物	わげもの
曲玉	まがたま
曲者	くせもの
曲舞	くせまい
曲見	しゃくみ
曲輪	くるわ
更格廬	カンガルー
更紗	サラサ
更衣	きさらぎ／ころもがえ
曷為	なんすれぞ
曷若	いかん
曹白魚	ひら
曹達水	ソーダスイ
曼識特	マンチェスター
曼谷	バンコク
曽孫	ひまご
曽祖母	ひいばば
曽祖父	ひいじじ
最中	もなか
最寄り	もより
最早	もはや
月不見月	つきみずづき
月代	さかやき
月即別	ウズベク
月次	つきなみ
月額	さかやき
有平糖	アルヘイトウ
有平隈	あるへいぐま
有心	うしん
服織	はとり
服部	はとり／はとりべ
朔日	ついたち
望月	もちづき
望潮	しおまねき
望潮魚	いいだこ
朝勤	あさじ
朝月夜	あさづくよ
朝朗	あさぼらけ
朝臣	あそん
朝靄	あさもや
朝餉	あさがれい／あさげ
朧月	おぼろづき
朧月夜	おぼろづきよ
木の葉時雨	このはしぐれ
木の葉木菟	このはずく
木下闇	こしやみ
木乃伊	ミイラ
木五倍子	きぶし
木偶	でく
木偶の坊	でくのぼう
木加	モカ
木匠	こだくみ
木天蓼	またたび
木尺	きがね
木屑	こけら
木履	きぐつ
木工	こだくみ
木強	ぼっきょう
木捻子	モクねじ
木斯甲	マスカット
木末	こぬれ
木染月	こぞめづき
木椎	さいづち
木槿	むくげ
木淡	きざわし
木漏日	こもれび
木瓜	きゅうり／マルメロ／ぼけ
木皮	こはだ
木綿	もめん／ゆう
木綿四手	ゆうシで
木綿垂	ゆうシで
木綿鬘	ゆうかずら
木耳	きくらげ
木膚	こはだ
木色	もくじき
木苺	きいちご
木菟	みみずく
木菟入	ずくニュウ
木菟鳥	つくとり
木蓮子	いたび
木蘭	モクレン
木螺子	モクねじ
木蠹虫	きくいむし
木賊	とくさ
木通	あけび
木醂	きざわし
未爾屈	マルク
未申	ひつじさる
未蘭	ミラノ
未通女	おぼこ
末枯	すがり
末殺	うらごけ
末濃	すそご
末葉	うれは
末黒野	すぐろの
本意無い	ほいない
朱欒	ザボン
朱波	ミャンマー
朱竹	せんねんぼく
朱華	はねず
朱華色	はねずいろ
朱蕉	せんねんぼく
朱鷺	とき
朴樹	えのき
朴歯	ほおば
朽野	くだらの
杉天牛	すぎかみきり
杉形	すぎなり
杉蘚	すぎごけ
李並士敦	リビングストン
李斯特	リスト
李頓	リットン
杏葉	ぎょうよう
杖球	ホッケー
杙鞋	くいぐつ
杜仲	はいまゆみ
杜夫魚	かくぶつ
杜宇	ほととぎす
杜松	ねず
杜漏	ずろう
杜父魚	かじか
杜翁	トルストイ
杜若	かきつばた
杜蒙	つくばねそう
杜衡	かんあおい
杜馬	デュマ
杜鵑	ほととぎす
杜鵑草	ほととぎす
束子	たわし
杠秤	ちきり／ちぎ／ちぎり
杠谷樹	ひいらぎ
条条	おちおち
条虫	さなだむし
杣人	そまびと
杣山	そまやま
来特（兄弟）	ライト
来路花	サルビア
東北風	ならい
東南風	いなさ
東屋	あずまや
東浄	とうちん
東男	あずまおとこ
東雲	しののめ
東風	こち
東風菜	しらやまぎく
松囃	まつばやし
松囃子	まつばやし
松明	たいまつ
松楊	ちしゃのき
松毟鳥	まつむしり
松毬	まつかさ／まつぼっくり
松江魚	スズキ
松脂	まつやに
松蘿	さるおがせ
松陰囊	まつぼっくり
松魚	かつお
板山葵	いたわさ
枌板	そぎいた
枕詞	まくらことば
果戈里	ゴーゴリ
果敢無む	はかなむ
果物	くだもの
果蜜	シロップ
枝尺蠖	えだしゃくとり
枝折	しおり
枡形	ますがた
枡目	ますめ
枯薄	かれすすき
枳殻	からたち
枸榾	ひいらぎ
枸橘	からたち
柄杓	ひしゃく
柑子	こうじ
染指草	ほうせんか
柔手	にこで
柔膚	やわはだ
柘植	つげ
柘榴	ざくろ
柚柑	ユコウ
柚餅子	ユベシ
柚香蒸し	ゆこうむし
柝頭	きがしら
柬蒲塞	カンボジア
柱技	ボーリング
柳宿	ぬりこぼし
柳葉菜	あかばな
柳葉魚	シシャモ
柳鮠	やなぎばえ
柴可夫斯基	チャイコフスキー
柴芝	まんねんたけ
査其孫	ジャクソン
査列斯	チャールズ
査科布森	ヤコブセン
栄蘭	たこのき
栄螺	さざえ
栗鼠	りす
校倉	あぜくら
栩板	とちいた
栲領巾	たくひれ
核太棗	さねぶとなつめ
根木打	ねっきうち
格禄亜祭	クロアチア
格綸僕	コロンボ
格蘭徳	グラント
格衣	はこえ
桃染	つきぞめ
桃短截象虫	モモチョッキリゾウムシ
桃花褐	あらぞめ
桃花鳥	とき
桃金嬢	てんにんか
桄榔	くろつぐ
桄榔子	くろつぐ
案山子	かかし
桑小卓	くわこじょく
桑拿	サウナ
桑港	サンフランシスコ
桑蚕	くわご
桜府	サクラメント
桜桃	さくらんぼう
桜海老	さくらえび
桜蓼	さくらたで
桜鯎	さくらうぐい
桟	えつり
桟俵法師	さんだらぼっち
桟手	さで
桟敷	さじき
桷	ずみ
梁簀	やなす
梃子	てこ
梃子摺る	てこずる
梅桃	ゆすらうめ
梅特林克	メーテルリンク
梅花皮	かいらぎ
梅里美	メリメ
梅雨	つゆ
梓巫	あずさみこ
梓巫女	あずさみこ
梔子	くちなし
梛筏	なぎいかだ
梛節	なぎぶし
梟帥	たける
梢殺	うらごけ
梧桐	あおぎり
梨子地	なしジ
梭子魚	かます
梭尾螺	ほらがい
梭貝	ひがい
梭配り	おさくばり
梭魚	かます
梯姑	デイコ
梯子	はしご
梳櫛	すきぐし
梳毛	すきげ
棒手振	ぼてふり
棘蟹	いばらがに
棘魚	とげうお
棠梨	ずみ
棠棣	はねず
検見	けみ
椿象	かめむし
楊桐	さかき
楊梅	やまもも
楊櫨木	うつぎ
楓蛾	しらがたろう
楚森	ソマリア
楡木茸	タモギタケ
楡皮	やにれ
業平竹	なりひらだけ
極光	オーロラ
極書	きわめがき
楽車	だんじり
榑木	くれき
榔楡	あきにれ
榕樹	がじゅまる
榛の木	はんのき
榾火	ほたび／ほだび
構の木	かじのき
槍柔魚	やりいか
槍烏賊	やりいか
槍衾	やりぶすま
槐葉蘋	さんしょうも
槓杆	てこ
槙皮	まいはだ
槭樹	かえで
樗蚕	しんじゅさん
標縄	しめなわ
標茅茸	しめじたけ
標野	しめの
権守	ごんのかみ
権衡	からばかり
横痃	よこね
横笛	ようじょう
樫鳥	かけす
樵夫	きこり
樸樹	むくのき
樹懶	なまけもの
樺太	からふと
橙色	だいだいいろ
機関	からくり
檀香	びゃくだん
檜柏	びゃくしん
檜皮	ひわだ
檜皮色	ひわだいろ
檜皮葺き	ひわだぶき
檬果	マンゴ
檸檬	レモン
檻檻	がらがら
櫂先	かいさき
櫺子	れんじ
欒樹	もくげんじ
欒琴	レントゲン
欠伸	あくび
欠唇	いぐち
欠片	かけら
欠米	かんまい
次妻	うわなり
次官	すけ
欣欣	にこにこ
欧姆	オーム
欧羅巴	ヨーロッパ
款冬	ふき／やまぶき
歌徳	ゲーテ
歌留多	カルタ
止比乎	とびうお
正占	ますら
正東風	まこち
正絹	しょうけん
正身	そうじみ
正面	まとも
正麩	しょうふ
此処	ここ
此奴	こいつ
此度	こたび
此所	ここ
此方	こちら
此方人等	こちとら
此畜生	こんちくしょう
此間	こないだ
武士	もののふ
武火	ぶが
武蔵	むさし
武達	ユタ
歩射	かちゆみ
歩荷	ぼっか
歩行虫	ごみむし／おさむし
歪阿那	ガイアナ
歳下食	さいげじき
歳刑神	さいぎょうしん
歴木	くぬぎ
段梯子	ダンばしご
段段	ぎざぎざ
段銭	たんせん
殺陣	たて
殿司	でんす
母家	おもや
母屋	おもや
母様	かかさま
母衣	ほろ
比利徳	ブリストル
比利時	ベルギー
比名罕	バーミンガム
比察	ピサ
比律悉	ブリュッセル
比律賓	フィリピン
比撒羅	ピサロ
比比丘女	ひふくめ
比目魚	ひらめ
比耳時	ベルギー
毛孔	けあな
毛布	ケット
毛斯綸	モスリン
毛球	バドミントン
毛織	もうる
毛莨	キンポウゲ・うまのあしがた
毛蚕	けご
毛蝨	けじらみ
毬打	ぎっちょう
毬杖	ぎっちょう
毬栗	いがぐり
毬藻	まりも
氈瓜	かもうり
氈鹿	かもしか
民答撓	ミンダナオ
気吹戸	いぶきど
気宇仙	きゅうせん
気虫	へひりむし
気触れる	かぶれる
気質	かたぎ
気障	きざ
水亀	いしがめ
水分	みくまり
水口	みなくち
水団	すいとん
水夫	かこ
水手	かこ
水押	みよし
水松	みる
水楊	かわやなぎ
水母	くらげ
水泡・水沫	みなわ
水洟	みずばな
水派	みなまた
水準	みずばかり
水漬く	みづく
水爬虫	たがめ
水狗	かわせみ
水獺	かわうそ
水球	ウォーターポロ
水瓶	みずがめ
水甕	みずがめ
水甘草	ちょうじそう
水竜骨	うらぼし
水端	みずはな
水簸	すいひ
水粒	みつぼ
水綿	あおみどろ
水翻	みずこぼし
水脈	みお
水芹	せり
水萍	きくさ
水葱	なぎ
水蓼	かわたで
水蔓青	ひめとらのお
水蘚	みずごけ
水蚤	みじんこ
水蠆	やご
水蠟樹	いぼたのき
水蠟樹蠟虫	いぼたろうむし
水豆児	たぬきも
水豹	あざらし
水雲	もずく
水馬	あめんぼ
水鶏	くいな
水黽	あめんぼ
水鼈	とちかがみ
氷下魚	こまい
氷州	アイスランド
氷柱	つらら
氷球	アイスホッケー
氷菓子	アイスクリーム
氷面	ひも
氷魚	こまい
永久	とわ／とこしえ
汗疹	あせも
汗肬	あせも
汗衫	かざみ
江浦草	つくも
江籬	おごのり
池溝	うなて
汽罐	ボイラー
沃やす	こやす
沃度	ヨード
沃度丁幾	ヨードチンキ
沃懸地	いかけジ
沈子	いわ
沈沈	しんしん
沈箱	じんばこ
沈菜	キムチ
沓手鳥	ほととぎす
沖膾	おきなます
沙子	いさご
沙穀椰子	さごやし
沙羅薬	ざらめきぐすり
沙翁	シェークスピア
沙蚕	ごかい
沙魚	はぜ
没分暁漢	わからずや
沢漆	とうだいぐさ
沢瀉	おもだか
沢胡桃	さわぐるみ
沢蒜	ねびる
沢鵯	さわひよどり
河内	かわち／ハノイ
河原	かわら
河岸	かし
河童	かっぱ
河豚	ふぐ
河貝子	かわにな
河骨	こうほね
沸沸	ぶつぶつ
油桃	つばいもも
油点草	ほととぎす
油照	あぶらでり
油石灰	セメント
油風	あぶらまじ
治部煮	じぶに
沼狸	ヌートリア
沿階草	じゃのひげ
法	フラン
法主	ほっす
法体	ほったい
法堂	はっとう
法夫満	ホフマン
法郎	フラン
法郎斯	フランス
法鼓	ほっく
泛子	うき
泡沫	うたかた
泡糖	カルメラ
泡銭	あぶくぜに
波哥達	ボゴタ
波士敦	ボストン
波布	はぶ
波徳里各	プエルトリコ
波斯	ペルシャ
波斯菊	はるしゃぎく
波止場	はとば
波羅的	バルチック
波落戸	ごろつき・ならずもの
波蘭	ポーランド
波里非	ボリビア
泥梨	ないり
泥濘	ぬかるみ
泥炭	すくも
泥犂	ないり
泥胡菜	きつねあざみ
泥部	はつかしべ
泥鰌	どじょう
注連縄	しめなわ
注連貰	しめもらい
注連飾り	しめかざり
泰	タイ
洋傘	こうもり
洋刀	サーベル
洋剣	サーベル
洋墨	インク
洋妾	らしゃめん
洋杯	コップ
洋灯	ランプ
洋玉蘭	たいさんぼく
洋琴	ピアノ
洋酒	ジン
洒落	しゃれ
洗膾	あらい
洗魚	あらい
洟垂れ	はなたれ
洪牙利	ハンガリー
洪都拉斯	ホンジュラス
活花	いけばな
活計	たつき
流石	さすが
流行	はやり
流行目	はやりめ
流行眼	はやりめ
流鏑馬	やぶさめ
浄海坊	じょうかいぼん
浄衣	じょうえ
浅傷	あさで
浅滅紫	うすけしむらさき
浅瓜	しろうり
浅甕	さらけ
浅茅	あさぢ
浅葱	あさつき
浜木綿	はまゆう
浜梨	はまなす
浜茄子	はまなす
浜鷸	はましぎ
浣熊	あらいぐま
浦回	うらみ
浦塩斯徳	ウラジオストク
浦廻	うらみ
浦曲	うらみ
浪花	なにわ
浪華	なにわ
浪速	なにわ
浮つく	うわつく
浮塵子	うんか
浮子	うき
浮気	うわき
浮石糖	カルメラ
浮腫	むくみ
浮萍	うきくさ
浮薔	みずあおい
浮鮴	うきごり
浴槽	ゆぶね
浴衣	ゆかた
海人	あま
海人草	まくり
海仁草	まくり
海克	ハーグ
海原	うなばら
海参	いりこ
海嘯	つなみ
海地	ハイチ
海女	あま
海州常山	くさぎ
海布	め
海扇	ほたてがい
海星	ひとで
海月	くらげ
海松	みる
海松布	みるめ
海松貝	みるがい
海栗	うに
海桐花	とべら
海涅	ハイネ
海燕	たこのまくら
海牙	ハーグ
海狗	おっとせい
海狸	ビーバー
海猟	らっこ
海獺	らっこ
海盤車	ひとで
海石榴	つばき
海石榴市	つばいち
海神	わたつみ
海索麺	うみぞうめん
海老	えび
海胆	うに
海舌	くらげ
海苔	のり
海若	わたつみ
海蘊	もずく
海蘿	ふのり
海蛆	ふなむし
海蛤	うむき
海螺	つぶ
海豚	いるか
海象	せいうち
海豹	あざらし
海路	うなじ
海酸漿	うみほおずき
海金砂	かにくさ
海鏡	つきひがい
海防	ハイフォン
海雲	もずく
海鞘	ほや
海頓	ハイドン
海馬	あしか／せいうち／たつ/のおとしご／とど
海驢	あしか
海髪	いぎす／おごのり
海鰻	あなご
海鷂魚	えい
海鼠	なまこ
海鼠子	このこ
海鼠腸	このわた
涅色	くりいろ
消梨	みずなし
消渇	しょうかち
淋巴	リンパ
淋巴腺	リンパセン
淋滲	つつげ
淑景舎	しげいしゃ
淘金	ゆりがね
淡漬	あまづけ
淡竹	はちく
淡緑	うすみどり
深傷	ふかで
深山	みやま
深山樒	みやましきみ
深山颪	みやまおろし
深沓	ふんごみ
深紅	こきべに・しんく
深緋	こきあけ
深雪	みゆき
混凝土	コンクリート
混合酒	カクテル
添水	ソウズ
清し女	すがしめ
清器	おかわ
清搔	すががき
清水	しみず
清汁	すましじる
清白	すずしろ
清箱	しのはこ
渋団扇	しぶうちわ
渚鳥	すどり
減上	めりかり
渟足柵	ぬたりのサク
温い	ぬるい
温和しい	おとなしい
温灰	ぬくばい
温石	おんじゃく
温突	オンドル
渾名	あだな
湯女	ゆな
湯巻	いまき
湯帷子	ゆかたびら
湯槽	ゆぶね
湯熨	ゆのし
湯熨斗	ゆのし
湿湿	じめじめ
満俺	マンガン
満剌加	マラッカ
満天星	はくちょうげ／どうだん/つつじ
満江紅	あかうきくさ
満満	なみなみ
溜込	たらしこみ
溝三歳	みそさざい
溝板	どぶいた
溝貝	どぶがい
滑滑	ぬめぬめ
滴滴	たらたら
滷汁	にがり
漁父	むらぎみ
漁翁	むらぎみ
漆姑草	つめくさ
漆瘡	うるしかぶれ
漏斗	じょうご
漏穴	くけあな
漏蘆	ひごたい
演し物	だしもの
漢人	あやひと
漢堡	ハンブルク
漢委奴国王	かんのわのなのくにおう
漢心	からごころ
漢意	からごころ
漢才	からざえ
漢竹	からたけ
漢織	あやはとり
漫事	すずろごと
漫漫	ぶらぶら
漫言	みだりごと
漫識特	マンチェスター
漬柿	あわしがき
漸漸	ようよう・だんだｎ
潜女	かずきめ
潮汁	うしおじる
潮泡／潮沫）	しおなわ
澪標	みおつくし
澱看席	よどみのせき
澳門	マカオ
濁声	だみごえ
濁酒	どぶろく
濁醪	どぶろく
濃漿	こんず
濃絵	だみえ
濃餅汁	のっぺいじる
濠太剌利	オーストラリア
濯ぐ	ゆすぐ
瀉腹	くだりばら
火傷	やけど
火光	かぎろい
火地	フエゴ
火床	ほど
火焼屋	ひたきや
火熨斗	ひのし
火酒	ウォッカ
火銃	ほづつ
火魚	かながしら
灯台木	みずき
灯台躑躅	どうだんつつじ
灯心	とうすみ
灯油	ともしあぶら
灯火	ともしび
灰汁	あく
灰神楽	はいかぐら
灰酒	あくざけ
灼然	いやちこ
炒飯	チャーハン
炙牛肉	ローストビーフ
炭斗	すみとり
点す	さす
点火	とぼし
点点	ちょぼちょぼ
点者	てんじゃ
点茶	たてちゃ
点茶盤	テーブル
為人	ひととなり
為体	ていたらく
為所	しどころ
為手	して
為替	かわせ
為登糸	のぼせいと
烏克蘭	ウクライナ
烏帽子	えぼし
烏干達	ウガンダ
烏拉乗	ウルグアイ
烏拉嶺	ウラル
烏拉爾	ウラル
烏敢大	ウガンダ
烏木	こくたん
烏樟	くろもじ
烏玉	ぬばたま
烏珠	ぬばたま
烏竹	くろちく
烏臼	なんきんはぜ
烏芋	くわい
烏草樹	さしぶ
烏豆	くろまめ
烏賊	いか
烏魯木斉	ウルムチ
烽火	のろし
焙ずる	ほうずる
焠す	なます
無価	むげ
無功用	むくゆう
無名指	ななしゆび
無射	ぶえき
無布施経	ふせないきょう
無患子	むくろじ
無情い	つれない
無礼	なめ
無神狗	やまいぬ
無花果	いちじく
無言	しじま
無頼	ごろつき
焦爾	ジュール
然う	そう
然して	さして
然様	さよう
然様なら	さようなら
然然	しかじか
然程	さほど
然迄	さまで
煎汁	いろり
煙火	はなび
煙管	キセル
煙草	タバコ
煮凝	にこごり
煮端	にばな
熊の胆	くまのい
熊啄木鳥	くまげら
熊川	コモガイ
熊猫	パンダ
熊葛	くまつづら
熊襲	くまそ
熊谷草	くまがいそう
熊野	ゆや
熟寝	うまい
熟熟	つくづく／つらつら
熟瓜	ほぞち
熟田	こなた
熟鮨	なれずし
熨斗	のし
熨斗目	のしめ
熨斗蚫	のしあわび
熨斗鮑	のしあわび
熬海鼠	いりこ
熱燗	あつかん
熾火	おきび
燐寸	マッチ
燕子花	かきつばた
燕魚	とびえい
燗酒	かんざけ
燧石	ひうちいし
燭光	カンデラ
燭魚	はたはた
燻柿	ふすべがき／くすべがき
燻革	ふすべがわ／くすべがわ
爆口	はぜぐち
爆竹	はなび
爆米	はぜ
爪哇	ジャワ
爪紅	つまぐれ
爰許	ここもと
爵牀	きつねのまご
父母	かぞいろは
爾白爾	ルーブル
片尼	ペニー
片才	かたかど
片方	かたえ
片木	へぎ
片田舎	かたいなか
片秀	かたほ
片膚	かたはだ
片辺	かたほとり
片靨	かたえくぼ
版位	へんに
牙婆	すあい
牙床	くれどこ
牙歯草	ひるむしろ
牙買加	ジャマイカ
牛宿	いなみぼし
牛尾菜	しおで
牛尾魚	こち
牛津	オックスフォード
牛皮凍	へくそかずら
牛皮消	いけま
牛筋草	おひしば
牛縻	はなづら
牛肉焼物	ビーフステーキ
牛膝	いのこずち
牛西蘭	ニュージーランド
牡蠣	かき
牴牾	もどき
牴牾しい	もどかしい
特牛	ことい・こというし
牽牛花	あさがお
犇犇	ひしひし
犠牲	いけにえ
犢鼻褌	ふんどし
犬の陰囊	いぬのふぐり
犬児	えのこ
犬公方	いぬくぼう
犬子	えのこ
犬榧	いぬがや
犬樟	いぬぐす
犬橇	のそ
犬蓼	いぬたで
犬黄楊	いぬつげ
狂公子	ハムレット
狂花	あだばな
狂詩曲	ラプソディー
狐日和	きつねびより
狐罠	きつねわな
狐臭	わきが
狐薊	きつねあざみ
狗尾草	えのころぐさ
狗母魚	えそ
狗筋蔓	なんばんはこべ
狗舌草	さわおぐるま
狗花椒	ふゆざんしょう
狩人	かりゅうど／かりうど
狩猟豹	チーター
狩衣	かりぎぬ
独り法師	ひとりぼっち
独り相撲	ひとりずもう
独楽	こま
独楽鼠	こまねずみ
独活	うど
独脚蜂	きばち
独逸	ドイツ
狭匙	せっかい
狭衣	さごろも
狭間	はざま
狭霧	さぎり
狼尾草	ちからしば
狼煙	のろし
狼藉日	ロウジャクニチ
猛者	もさ
猟人	かりゅうど
猟夫	さつお
猟男	さつお
猟虎	らっこ
猪牙	チョキ
猪牙船	ちょきぶね
猪籠草	うつぼかずら
猴酒	さるざけ
猶太	ユダヤ
猿公	えてこう
猿子	ましこ
猿真似	さるまね
猿麻桛	さるおがせ
獅噛	しがみ
獅子国	スリランカ
獅子頭	ししがしら
獺虎	らっこ
玄人	くろうと
玄参	ごまのはぐさ
玄孫	やしゃご
玄蕃寮	げんばりょう
玉柏	まんねんすぎ
玉環菜	ちょろぎ
玉章	たまずさ
玉筋魚	いかなご
玉簪花	たまのかんざし／ぎぼうし
玉蕈	しめじ
玉蕊	さわふじ
玉蘭	はくもくれん
玉蜀黍	とうもろこし
玉蝉花	はなしょうぶ
玉螺	つめたがい
玉鈴花	はくうんぼく
玉響	たまゆら
王不留行	どうかんそう
王余魚	かれい
王瓜	からすうり
王茸	しめじ
玖瑪	キューバ
玖馬	キューバ
玩具	おもちゃ
玫瑰	はまなす
玻里非	ボリビア
珈琲	コーヒー
珊米突	センチメートル
珍珠花	ゆきやなぎ
珍珠菜	おかとらのお
珠鶏	ほろほろちょう
班烈多	ハムレット
班田	あかちだ
現世	うつしよ
現人	うつせみ
現身	うつしみ
琉球児	リキュール
琳閣倫	リンカーン
琴柱	ことじ
瑞典	スウェーデン
瑞士	スイス
瑞西	スイス
瑞香	じんちょうげ
瑟抜私窒安	セバスチャン
瑠璃鳥	るり
瑣格刺底	ソクラテス
瑪利亜	マリア
瑪理花	あじさい
瑪理蘭	メリーランド
瑪金叨斯	マキントッシュ
瑪雷西亜	マレーシア
瓊矛	ぬほこ
瓊脂	ところてん
瓊音	ぬなと
瓜姆	グアム
瓢の実	ひょんのみ
瓢虫	てんとうむし
瓦侖	ガロン
瓦徳	ワット
瓦斯	ガス
瓦格納	ワグナー
瓦稜薩	バレンシア
瓦羅牟	グラム
瓦落	がらがら
瓦蘭姆	グラム
瓶子	へいじ
瓶爾小草	はなやすり
甃石	しきいし
甘海苔	あまのり
甘煮	うまに
甘田	あまきだ
甘葛	あまづら
甘蔖	さとうきび
甘蕉	バナナ
甘藷	さつまいも
甘野老	あまどころ
甘露子	ちょろぎ
甚三紅	じんざもみ
甚振る	いたぶる
甚雨	ひさめ
甜橙	オレンジ
甜瓜	まくわうり
生え抜き	はえぬき
生き甲斐	いきがい
生さぬ仲	なさぬなか
生一本	きいっぽん
生世話	きぜわ
生姜	しょうが
生憎	あいにく
生業	なりわい
生海布	なまめ
生渋	きしぶ
生疵	なまきず
生皮苧	きびそ
生直	きすぐ
生真面目	きまじめ
生節	なまりぶし
生簀	いけす
生絹	すずし
生蕎麦	きそば
生薑	しょうが
生血	のり
生飯	さば
生馬	いけま
生魑魅	いきすだま
産土	うぶすな
産土神	うぶすながみ
産衣	うぶぎ
産霊神	むすびのかみ
田中螺	たつび
田人	たうど
田字草	うきくさ
田舎	いなか
田荘	たどころ
田雲雀	たひばり
田鳧	たげり
田鶴	たず
甲乙	かるめる
甲子	きのえね
甲斐	かい
甲斐性	かいショウ
甲斐甲斐しい	かいがいしい
甲斐絹	かいき
甲矢	はや
甲虫	かぶとむし
甲谷佗	カルカッタ
男伊達	おとこだて
男茎	おはせ
男郎花	おとこえし
男鰥	おとこやもめ
画工司	えだくみのつかさ
画韋	えがわ
畔道	あぜみち
畔頭	くろがしら
畢宿	あめふりぼし
畢撤	ピサ
番匠屋	ばんじょうや
番瀝青	ペンキ
番紅花	サフラン
番鳥	つがいどり
番鴛鴦	つがいおし
畳紙	たとうがみ
疝	しらたみ
疣蛙	いぼがえる
疫病	えやみ
疫病草	えやみぐさ
疵物	きずもの
疾い	はやい
疾うに	とうに
疾風	はやて
病葉	わくらば
痘痕	あばた
痘瘡	もがさ
痩ける	こける
痴事	しれごと
痴絵	おこえ
痿痢	しびり
瘡瘡	くも
瘡蓋	かさぶた
瘧草	えやみぐさ
癭蜂	たまばち
発条	ばね／ぜんまい
発船	ふなだち
白令	ベーリング
白前	すずめのおごけ
白南風	しろはえ
白及	しらん
白地	あからさま
白女	しゃれおんな
白妙	しろたえ
白屈菜	くさのおう
白朮	おけら
白朮祭	おけらまつり
白柳樹	ポプラ
白栲	しろたえ
白梨樹	うらじろのき
白楊	はこやなぎ
白檜曾	しらびそ
白浪	しらなみ
白湯	さゆ
白灯蛾	しろひとり
白熊	はぐま
白痢	なめ
白癜	しろなまず
白癩	しらはたけ
白癬	しらくも
白眼	さめ
白禿瘡	しらくも
白粉	おしろい
白粉花	おしろいばな
白耳義	ベルギー
白膠木	ぬるで
白芋	はすいも
白芝	よろいぐさ
白花菜	ふうちょうそう
白英	ひよどりじょうご
白茅	ちがや
白菜	パクチョイ
白薇	ふなばらそう・まかご
白襖	しらあお
白襲	しらがさね
白辛樹	あさがら
白酒	しろき
白雨	ゆうだち
白露西亜	ベラルーシ
白面	しらふ
白頭翁	おきなぐさ
白馬	あおうま
白髪	しらが
白髪太郎	しらがたろう
白魚	にごい
百世	ももよ
百両金	からたちばな
百代	ももよ
百千	ももち
百合	ゆり
百合鷗	ゆりかもめ
百夜	ももよ
百敷	ももしき
百日紅	さるすべり
百済	くだら
百磯城	ももしき
百篝	ももかがり
百脈根	みやこぐさ
百舌	もず
百舌勘定	もずカンジョウ
百足	むかで
百部	びゃくぶ・ほとずら
百里斯	ベリーズ
百里香	タイム
百重	ももえ
皁莢	さいかち
的木児	ティモール
的波里	トリポリ
皆焼	ひたつら
皇女	みこ
皇子	みこ
皇神	すめがみ
皐月	さつき
皮茸	こうたけ
皺腹	しわばら
皿鉢	さわち
益母草	めはじき
益無し	ようなし
益益	ますます
益荒男	ますらお
盗汗	ねあせ
盛相	もっそう
盟神探湯	くかたち
監物	けんもつ
盤渉調	ばんしきちょう
盤秤	さらばかり
盤谷	バンコク
盤領	あげくび
盧旺達	ルワンダ
盧梭	ルソー
盧森堡	ルクセンブルク
目合	まぐわい
目差	まなざし
目弾	めはじき
目指	まなざし
目癈	めしい
目眩	めまい
目翳	ひ
目脂	めやに
直垂	ひたたれ
直心	ひたごころ
直様	すぐさま
直歳	シッスイ
直火	じかび
直衣	のうし
直足袋	じかたび
直路	ひたみち
直違	すじかい
直面物	ひためんもの
相好	ソウゾウ
相撲	すもう
相模	さがみ
相部屋	あいべや
省沽油	みつばうつぎ
眉児豆	いんげんまめ
眉尖刀	なぎなた
眉庇	まびさし
眉相	まみあい
看々臘月尽	みよみよろうげつつく
看一	ちょっと
看督長	かどのおさ
看経	カンキン
看麦娘	すずめのてっぽう
県主	あがたぬし
県召	あがためし
真似	まね
真具	まつぶさ
真化	しんけ
真奪	しんばい
真東風	まこち
真田紐	さなだひも
真田虫	さなだむし
真砂	まさご
真秀	まほ
真章魚	まだこ
真葛	さねかずら
真蒸し	まぶし
真薦	まこも
真面	まとも
真面目	まじめ
真風	まじ
眠蔵	めんぞう
眠蚕	いこ
眩暈	めまい
眼子菜	ひるむしろ
眼差	まなざし
眼張	めばる
眼指	まなざし
眼旗魚	めかじき
眼路	めじ
眼鏡	めがね
眼間	まなかい
着心地	きごこち
着衣始	きそはじめ
睡菜	みつがしわ
睡蓮	ひつじぐさ
睦月	むつき
睦言	むつごと
睨める	ねめる
睫毛	まつげ
瞳瞳	とうとう
瞽女	ごぜ
瞿麦	なでしこ／せきちく
矢作	やはぎ
矢叫	やたけび
矢場	やにわ
矢籠	しこ
矢絣	やがすり
矢飛白	やがすり
知客	しか
知更雀	こまどり
知母	はなすげ
知章	ともあきら
矩計図	かなばかりず
短手	しのびで
矮鶏	チャボ
矮鹿	まめじか
石伏魚	ごり
石城	いしき／いわき
石塊	いしころ
石子	いしなご
石投	いしなご
石持	こくもち
石斑魚	うぐい
石松	ひかげのかずら
石楠花	しゃくなげ
石榴	ざくろ
石槨	いしき／いわき
石決明	あわび
石漆	せしめうるし
石竜子	とかげ
石竜牙草	いしもちそう
石竹	からなでしこ
石胡萎	ちどめぐさ
石花	せ
石花菜	てんぐさ
石茸	いわたけ
石蒜	ひがんばな
石蓴	あおさ
石蕊	はなごけ
石蕗	つわぶき
石蚕	いさごむし
石見	いわみ
石陰子	かせ
石韋	ひとつば
石首魚	いしもち
石鹸玉	しゃぼんだま
砂利	じゃり
砂滑	すなめり
砂糖天麩羅	ドーナツ
砥粉色	とのこいろ
砲音	つつおと
破垣	やれがき
破天連	バテレン
破礼	ばれ
破落戸	ごろつき
硝子	ガラス
硫黄	いおう
碾臼	ひきうす
磐座	いわくら
磚子苗	いぬくぐ
磨硝子	すりガラス
磨臼	すりうす
磯城	しき
磯蚯蚓	いそめ
磯魚	いさな
礬水	どうさ
礼陰	ライン
祈年	としごい
祈年祭	としごいのまつり
祈狩り	うけいがり
祓殿	はらえどの
祖 母	おおば
祖父	おおじ
祝女	のろ・はふりめ
祝歌	ほぎうた
祝言人	ほかいびと
祝詞	のりと／ほぎご と
神冠	かみこうぶり
神子	みこ
神実	かんざね
神巫	いちこ
神庫	ほくら
神戸	かんべ
神楽	かぐら
神楽月	かぐらづき
神籠石	こうごいし
神籬	ひもろぎ
神輿	みこし
神酒	みき
神馬	じんめ
神馬藻	ほんだわら
祥瑞	しょんずい
禊萩	みそはぎ
禍事	まがごと
禍神	まがかみ
禍言	まがごと
福特	フォード
福礼門	フリーマン
禾手	のぎで
秀枝	ほつえ
秋入梅	あきついり
秋刀魚	さんま
秋日和	あきびより
秋桜	コスモス
秋楡	あきにれ
秋沙	あいさ
秋波	ながしめ
秋渇	あきかわき
秋蚕	あきご
秋黴雨	あきついり
科威都	クウェート
科白	せ りふ
秘色	ひそく
秘露	ペルー
秦皮	とねりこ
秧鶏	くいな
称辞	たたえごと
移徙	わたまし
稍稍	やや
稚児	ちご
稚子	みずこ
稚海藻	わかめ
稚鰤	わらさ
稜威	いつ
種種	くさぐさ
稲幹	いながら
稲架	はさ
稲熱病	いもちビョウ
稲積	にお
稲立毛	いなたちげ
稲舂虫	いねつきむし
稲荷	いなり
稲魂	うかのみたま
稲魂女	うかのめ
穆爾	ムーア
積丹竹	しゃこたんちく
穎割れ	かいわれ
穏斯	オンス
究竟	くっきょう
空五倍子	うつぶし
空勘文	うつぼかもん
空木	うつぎ
空柴	うつぶし
空梅雨	からつゆ
空穂	うつぼ
空籤	からくじ
空薫	そらだき
空鬮	からくじ
突尼斯	チュニス
窃窃	こそこそ
窃衣	やぶじらみ
窒扶斯	チフス
窩主	けいず
窩主買	けいずかい
窶窶しい	やつやつしい
竈食い	へぐい
立ち退く	たちのく
立人	たちうど
立付	たっつけ
立女形	たておやま
立纓	りゅうえい
立脱耳	リットル
立鼓	りゅうご
竜爪稗	しこくびえ
竜胆	りんどう
竜葵	うみほおずき
竜蝦	いせえび
竜蝨	げんごろう
竜髭菜	アスパラガス
章魚	たこ
童巫女	わらわみこ
童巫子	わらわみこ
童男	おぐな
童謡	わざうた
端白	つまじろ
端端	つまづま
端色	はしたいろ
端食	はしばみ
竹刀	しない
竹柏	なぎ
竹根蛇	ひばかり
竹瓮	たっぺ
竹皺	たけしぼ
竹筒	ささえ
竹箸魚	あじ
竹節虫	ななふし
竹篦	しっぺい
竹篦返し	しっぺがえし
竹籤	たけひご
竹輿舁	かごかき
竹麦魚	ほうぼう
笈摺	おいずる
笊籬	いかき
笊蕎麦	ざるそば
笑尉	わらいじょう
笑靨花	しじみばな
笑顔	えがお
第希蘭	テヘラン
筆忠実	ふでまめ
筆頭菜	つくし
等閑	なおざり
筋違	すじかい
答拝	たっぱい
筥陶司	はこすえのつかさ
筬虫	おさむし
箇失密	カシミール
箒星	ほうきぼし
箒木	ほうきぎ／ははきぎ
箒草	ほうきぐさ
箕宿	みぼし
箕被	みかずき
算盤	そろばん
箝げる	すげる
箱梯子	はこばしご
節季候	せきぞろ
節木樵	せちぎこり
築山	つきやま
築牆	ついジ／ついがき
篠の子	すずのこ
篠懸の木	すずかけのき
篠竹	ささたけ／すずたけ
簀垣	すがき
簀巻	すまき
簓桁	ささらげた
簾名残	すだれなごり
籃球	バスケットボール
籐球	セパタクロー
籟初	ふきぞめ
籠句	ロック
籠球	バスケットボール
籬垣	ませがき
籬架菊	ませぎく
米利堅	メリケン
米勒	ミュラー
米櫃	こめびつ
米突	メートル
米粉	ビーフン
米細勒	ミシュレ
米蘇利	ミズリー
米詩干	ミシガン
粉粥	ふずく
粗栲	あらたえ
粗榧	いぬがや
粗目	ざらめ
粗目雪	ざらめゆき
粗薦	あらこも／あらごも
粘土	へなつち
粘葉装	でっちょうそう
粛慎	みしはせ
粟米草	ざくろそう
粳稲	うるしね
糅飯	かてめし
糖酒	ラム
糠蝦	あみ
糯米	もちごめ
糯粟	もちあわ
糴取	せどり
糶取	せどり
糶市	せりいち
糸巻鱏	いとまきえい
糸杉	キプロス
糸瓜	へちま
糸縒鯛	いとよりだい
糸葱	あさつき
糸蜻蛉	いととんぼ
糸遊	いとゆう
糸魚	いとよ
約但	ヨルダン
約翰	ヨハネ
紅南瓜	きんとうが
紅型	びんがた
紅娘	てんとうむし
紅樹	おひるぎ
紅殻	ベンガラ
紅玉	ルビー
紅白粉	べにおしろい
紅糟粥	うんぞうがゆ
紅絹	もみ
紅菜	とさかのり
紅菰	べにたけ
紅葉	もみじ
紅葉卸し	もみじおろし
紅葉狩り	もみじがり
紅葉葵	もみじあおい
紅藍花	べにばな
紅蜀葵	もみじあおい
紅鶸	べにひわ
紋甲烏賊	もんごういか
納所	ナッショ
納斯欽	ラスキン
納涼	すずみ
納爾孫	ネルソン
納音	ナッチン
紐育	ニューヨーク
紐頓	ニュートン
紕う	まよう
紗綾	さや
紙屋紙	こうやがみ
紙捻	こより
紙撚	こより
紙礫	かみつぶて
紙縒	こより
紙衣	かみこ
紙鑢	かみやすり
紙魚	しみ
紙鳶	たこ
素人	しろうと
素地	きじ
素掛威	すがけおどし
素朧	そぼろ
素湯	さゆ
素破	すわ
素見す	ひやかす
素面	しらふ
素馨	ジャスミン
素魚	しろうお
紡錘	つむ
索麵	そうめん
紫丁香花	ライラック
紫参	はるとらのお
紫松	いちい
紫繍毬	あじさい
紫羅欄花	あらせいとう
紫茉莉	おしろいばな
紫荊	はなずおう
紫菜	あまのり
紫萁	ぜんまい
紫萼	ぎぼうし
紫薇	さるすべり
紫金牛	やぶこうじ
紫陽花	あじさい
紫雲英	れんげそう／げんげ
紫雲草	すずむしそう
紫香楽宮	しがらきのみや
細枝	しもと
細流	せせらぎ
細瓮	ささべ
細石	さざれいし
細細里	シシリー
細螺	きさご
細雪	ささめゆき
細魚	さより
紺珠	かんじゅ
終夜	よもすがら
終日	ひねもす／ひもすがら
経師屋	きょうじや
経帷子	キョウかたびら
経糸	たていと
経緯	いきさつ
経行	きんひん
結政所	かたなしどころ
結綿	ゆいわた
結解状	けちげじょう
絞股藍	あまちゃづる
絡新婦	じょろうぐも
継子	ままこ
継母	ままはは
継粉	ままこ
続断	なべな
続飯	そくい
綜麻	へそ
綜麻繰り	へそくり
綟子	もじ
綟網	もじあみ
維也納	ウィーン
維廉底爾	ヴィクトリア
維納	ウイーン
綱麻	つなそ
網結	あみすき
綽名	あだな
綾子	リュウズ
緇門	くろかど
緊と	ひしと
緊唇	あくち
緊緊	ぴしぴし
緋水鶏	ひくいな
緋秧鶏	ひくいな
緋縮緬	ヒぢりめん
緋衣	あけごろも
総桜	ふさざくら
総総	ふさふさ
総角	あげまき
緑啄木鳥	あおげら
緑豆	やえなり
緑青	ロクショウ
緑鳩	あおばと
緒総	おぶさ
線滞	レース
線虫	はりがねむし
編木	びんざさら
緩火	ぬるび
緬甸	ビルマ
緯糸	ぬきいと／よこいと
練墨	こねずみ
縄暖簾	なわのれん
縄綯	なわない
縒襁	ひむつき
縕袍	どてら
縛める	いましめる
縦令	たとい／たとえ
縦褌	たてみつ
縮緬	ちりめん
縮緬雑魚	ちりめんじゃこ
縮縫	いせ
縮羅	しじら
縵面	なめ
縹緻	きりょう
縹色	はなだいろ
縹草	はなだぐさ
績苧	うみお
績麻	うみお
繁吹	しぶき
繁縷	はこべ／はこべら
繁繁	しげしげ
繃標烏	ポンペイウス
繊弱	ひわず
繊細い	かぼそい
繡眼児	めじろ
纈草	かのこそう
纏頭	はな
罌粟	けし
罔象	みずは
罕得爾	ヘンデル
置賜紬	おいたまつむぎ
羅凌士	ローレンス
羅宇	ラオ
羅府	ロサンゼルス
羅斯福	ルーズベルト
羅漢松	いぬまき
羅漢柏	あすなろ
羅蘭	ロラン
羅西尼	ロッシーニ
羅該児	ラッセル
羅馬	ローマ
羅馬尼亜	ルーマニア
羊乳	つるにんじん
羊机子	おおさんざし
羊栖菜	ひじき
羊歯	しだ
羊蹄	ぎしぎし
羊躑躅	もちつつじ
羊駝	ラマ
羊駱駝	アルパカ
美し国	うましくに
美人局	つつもたせ
美作	みまさか
美女桜	バーベナ
美豆良	みずら
羚羊	かもしか
羞悪	しゅうお
羽子	はね
羽球	バドミントン
羽礼須多院	パレスチナ
羽蝨	はじらみ
羽隠虫	はねかくし
羽魚	かじき
翁加里亜	ハンガリー
翁草	おきなぐさ
翌檜	あすなろ
翡翠	かわせみ
翹揺	げんげ
翻筋斗	もんどり
翻車魚	まんぼう
翼宿	たすきぼし
老女	おうな
老弥児	ミル
老成	ひね
老次	おいなみ
老海鼠	ほや
老科	ロック
老舗	しにせ
老虎花	れんげつつじ
老酒	ラオチュウ
老鴉瓜	からすうり
考老来桂	コロラド
考老母	コロンボ
耆那教	ジャイナキョウ
耳漏れ	みみだれ
耳環	みみわ
耳許	みみもと
耶悉茗	ジャスミン
耶路撒冷	エルサレム
聒聒児	くつわむし
聖意勒納	セントヘレナ
聖教	しょうぎょう
聖林	ハリウッド
聖路易	セントルイス
聞説	きくならく
聞道	きくならく
聴す	ゆるす
聴牌	チンパイ
肉刺	まめ
肉汁	スープ
肉芽	にくげ
肌理	きめ
股座	またぐら
股引	ももひき
股立	ももだち
肥担桶	こえたご
肩巾	ひれ
肩衣	かたぎぬ
肬取木	いぼたのき
肬毟	いぼむしり
肬蛙	いぼがえる
肬鯛	いぼだい
育加来涅	ウクライナ
胃宿	えきえぼし
背向	そがい
背腸	せわた
背負子	しょいこ
背面	そとも
胞衣	えな
胡坐	あぐら
胡孫眼	さるのこしかけ
胡座	あぐら
胡枝子	はぎ
胡枝花	はぎ
胡桃	くるみ
胡燕子	あまつばめ
胡瓜	きゅうり
胡籙	やなぐい
胡粉	ごふん
胡菫菜	えぞすみれ
胡蘿蔔	にんじん
胡蜂	すずめばち
胡蝶樹	やぶでまり
胡蝶花	しゃが
胡豆	いわふじ
胡銅器	さはり
胡頽子	ぐみ
胡飲酒	こんじゅ
胡黄蓮	せんぶり
胡黎	きやんま
胯座	またぐら
胸座	むなぐら
胼胝	たこ
能留英	ノルウェー
脊黄青鸚哥	せきせいいんこ
脚榻	キャたつ
脚結	あゆい
脛巾	はばき
脛楯	はいだて
脛衣	はばき
脱る	とる
腋臭	わきが
腑甲斐無い	フがいない
腕弛い	かったるい
腰輿	たごし
腸線	ガット
腸香	わたか
腹不立	はらたてず
膂宍	そしし
膃肭獣	おっとせい
膃肭臍	おっとせい
膝甲	はいだて
膝行る	いざる
膠泥	モルタル
膠灰	セメント
膳夫	かしわで
膳棚	おものだな
臆虫	おめむし
臍落	ほぞち
臑当	すねあて
臥亜	ゴア
臥児狼徳	グリーンランド
臥処	ふしど
臥所	ふしど
臨瀝	したてゆばり
自棄	やけ
自鳴琴	オルゴール
臭梧桐	くさぎ
臭椿	にわうるし
臭橙	かぶす
臭牡丹樹	くさぎ
興渠	にら
舌疾	したど
舌鮃	したびらめ
舎人	とねり
舎路	シアートル
舟折敷	ふなおしき
舫船	もやいぶね
舳先	へさき
船縁	ふなべり
船首	みよし
良人	おっと
良候	ようそろ
色丹	しこたん
色丹草	しこたんそう
艶く	なまめく
艶姿	あですがた
芋幹	いもがら
芋苗	ずいき
芋茎	ずいき
芋茎祭	ずいきまつり
芝生	しばふ
芝草	まんねんたけ
芥子	からし
芥子菜	からしな
芥虫	ごみむし
芬蘭	フィンランド
花仙	かいどう
花地	フロリダ
花弁	はなびら
花斑鳥	かのこどり
花旗国	アメリカ
花柏	さわら
花梨	かりん
花梨樹	ローズウッド
花椰菜	カリフラワー
花楸樹	ななかまど
花櫚	かりん
花泛亭	かへんてい
花満的	バーモント
花潜	はなむぐり
花片	はなびら
花瑠瑠	ホノルル
花環	はなわ
花筐	はながたみ
花籠	けこ
花薄	はなすすき
花蝶	はなぜせり
花詞	はなことば
花鋏	はなばさみ
花鑢	はなやすり
花魁	おいらん
花魁草	おいらんそう
花鶏	あとり
芹子	せり
芽花椰菜	ブロッコリー
苔竜胆	こけりんどう
苔筵	こけむしろ
苛々	いらいら
苛性曹達	カセイソーダ
苛苛	いらいら
苜蓿	うまごやし
苞苴	つと／あらま き
苟且	かりそめ
若しも	もしも
若人	わこうど
若子	わくご
若布	わかめ
若干	そこばく
若気る	にやける
若狭	わかさ
若草	せきしょうも
苦参	くらら
苦塩	にがり
苦患	くげん
苦根草	めはじき
苦棟樹	にがき
苦汁	にがり
苦竹	まだけ
苦艾	チェルノブイリ・にがよもぎ
苦苣苔	いわたばこ
苦菜	のげし
苧屑頭巾	おくそズキン
苧麻	からむし
英倫	イングランド
英吉利	イギリス
英寸	インチ
英斤	ポンド
英桃	ゆすらうめ
英町	エーカー
英蘭土	イングランド
英里	マイル
英釐安納	インディアナ
茄子	なす
茄子紺	なすコン
茅渟鯛	ちぬだい
茅生	ちふ
茅膏菜	いしもちそう
茅花	つばな
茅蕈	こうたけ
茅蜩	ひぐらし
茗荅鬧	ミンダナオ
茜草	あかね
茫栗	マンゴスチン
茱萸	ぐみ
茶子味梅	ちゃさんばい
茶梅	さざんか
草履	ぞうり
草木瓜	くさぼけ
草本威霊仙	くがいそう
草烏頭	とりかぶと
草石蚕	ちょろぎ
草蝦	てながえび
草連玉	くされだま
草雲雀	くさひばり
草鞋	わらじ
荊棘	おどろ
荊芥	けいがい
荒びれる	さびれる
荒和布	あらめ
荒塊	あらくれ
荒家	あばらや
荒屋	あばらや
荒布	あらめ
荒磯	ありそ
荒鮎	さびあゆ
荒麻	あらそ
荷包牡丹	けまんそう
荷轄	にくさび
莎草	はますげ／かやつりぐさ/／ささめ
莫三鼻給	モザンビーク
莫告藻	なのりそ
莫大小	メリヤス
莫奈	モネ
莫差特	モーツァルト
莫斯科	モスクワ
莫泊三	モーパッサン
莫臥児	モール・モンゴル
莫迦	ばか
莫里哀	モリエール
莱府	ライプチヒ
莽塔那	モンタナ
菅麻	すがそ
菓争	このみあらそい
菓子	ボンボン
菖蒲	あやめ
菜亀虫	ながめ
菜椿象	ながめ
菜瓜	つけうり
菜種梅雨	なたねづゆ
菜蕗	ふき
菜豆	いんげんまめ
菟糸	ねなしかずら
菟葵	いそぎんちゃく
菫菜	つぼすみれ
華府	ワシントン
華徳路	ワーテルロー
華玆華司	ワーズワース
華盛頓	ワシントン
華表	とりい
萊府	ライプチヒ
萊草	しば
萌す	きざす
萌黄	もえぎ
萱草	かんぞう
萵苣	ちしゃ
落人	おちゅうど／おちうど
落文	おとしぶみ
落機	ロッキー
落葉松	からまつ
落葵	つるむらさき
落霜紅	うめもどき
葉手	ひらで
葉椀	くぼて
葉皮休緑斯	エピクロス
葉盤	ひらで
葉羽奈	ハバナ
葎穂	ホップ
著羅絹	チョロケン
著長	きせなが
葛折	つづらおり
葛拉徳士呑	グラッドストン
葛箙	つづらえびら
葛籠	つづら
葛藤	つづらふじ
葡萄	えび
葡萄牙	ポルトガル
葡萄茶	えびチャ
葡萄酒	ワイン
葦牙	あしかび
葦簀	よしず
葦雀	よしきり
葩煎	はぜ
葬帷子	はぶりかたびら
葭簀	よしず
葱頭	たまねぎ
葱鮪	ねぎま
蒔蘿	いのんど
蒙兀	モンゴル
蒙娜麗莎	モナリザ
蒟醬	キンマ
蒟醬塗	キンマぬり
蒲公英	たんぽぽ
蒲桃	ふともも
蒲葵	びろう
蒲魚	かまとと
蒸す	ふかす
蒸籠	せいろう
蒼朮	おけら
蒼鷹	おおたか
蒿雀	あおじ
蓄縮	きっしく
蓬子菜	かわらまつば
蓮華躑躅	れんげつつじ
蔓椒	ほそき
蔓荊	はまごう
蔚山（の戦い）	うるさん
蔦紅葉	つたもみじ
蔵人	くろうど
蕀苑	いとひめはぎ
蕁麻	いらくさ
蕃南瓜	とうなす
蕃杏	つるな
蕃椒	とうがらし
蕃瓜樹	パパイア
蕃茄	トマト
蕎麦	そば
蕎麦搔き	そばがき
蕎麦湯	そばゆ
蕎麦葉貝母	うばゆり
蕪菁	かぶら／かぶ
蕭本浩	ショーペンハウアー
蕭邦	ショパン
薄氷	うすらひ
薄粧	うすけわい
薄紅	うすぐれない
薄縁	うすべり
薄鈍	うすにび／うすのろ
薊馬	あざみうま
薔薇	ばら
薙刀	なぎなた
薛茘	いたびかずら
薬子の変	くすこのへん
薯蕷	とろろ
藁蓋	わろうだ
藍菊	えぞぎく
藍辛	ラシーヌ
藤浪	ふじなみ
藤葛	ふじかずら
藪手毬	やぶでまり
藪柑子	やぶこうじ
藪煙草	やぶたばこ
藪蝨	やぶじらみ
藺草	いぐさ
藻掻く	もがく
蘆虎	けけし
蘆辺踊	あしべおどり
蘇丹	スーダン
蘇亦斉	スエーデン
蘇士	スエズ
蘇格蘭	スコットランド
蘇民書札	そみかくだ
蘇門答剌	スマトラ
蘭波	ランボー
蘭草	ふじばかま
蘭貢	ラングーン
蘿蔔	すずしろ
虎列剌	コレラ
虎刺	ありどおし
虎子	まる
虎尾蘭	ちとせらん
虎掌	うらしまそう
虎斑	とらふ
虎杖	いたどり
虎眼	トラコーマ
虎耳草	ゆきのした
虎茄	はしりどころ
虎落	もがり
虎落笛	もがりぶえ
虎魚	おこぜ
虎鶫	とらつぐみ
虚事	そらごと
虚宿	とみてぼし
虚虚	うかうか
虚言	そらごと
虚貝	うつせがい
虞美人草	ひなげし
虫唾	むしず
虫白蠟	いぼたロウ
虫螻	むしけら
虫酸	むしず
虫鰈	むしがれい
蚊帳	かや
蚊帳吊草	かやつりぐさ
蚊母樹	いすのき
蚊母鳥	よたか
蚊蜻蛉	うすばかげろう
蚌貝	からすがい
蚕簿	まぶし
蚕繭草	さくらたで
蚕豆	そらまめ
蚕飼	こがい
蚕養焼	こがいやき
蚯蚓	みみず
蚰蜒	げじ
蛆虫	うじむし
蛇滅草	はぶそう
蛇牀	はまぜり
蛇目	じゃのめ
蛇眼草	いわがねそう
蛇舅母	かなへび
蛇苺	へびいちご
蛇菰	つちとりもち
蛇藤	くまやなぎ
蛇麻	からはなそう
蛍烏賊	ほたるいか
蛍蛆	つちぼたる
蛙手	かえで
蛙黽	あまがえる
蛞蝓	なめくじ
蛤仔	あさり
蛤鍋	はまなべ
蛭子	えびす
蛭蓆	ひるむしろ
蛸部屋	たこべや
蜀椒	なるはじかみ／さんしょう
蜀葵	たちあおい
蜀魂	ほととぎす
蜀魄	ほととぎす
蜀黍	もろこし
蜃楼	かいやぐら
蜆汁	しじみじる
蜆花	しじみばな
蜈蚣	むかで
蜉蝣	かげろう
蜘蛛	くも
蜘蛛抱蛋	はらん
蜘蛛膜下出血	くもマクカシュッケツ
蜚蠊	ごきぶり
蜥蜴	とかげ
蜷局	とぐろ
蜻蜓	とんぼ/かげろう/やんま
蝉鳴器	ブザー
蝌蚪	おたまじゃくし
蝘蜓	とかげ
蝙蝠	こうもり
蝦夷	えぞ／えみし
蝦夷菊	えぞぎく
蝦夷菫	えぞすみれ
蝦虎魚	はぜ
蝦蛄	しゃこ
蝮草	まむしぐさ
蝲蛄	ざりがに
蝸牛	かたつむり
蝸牛被	まいまいかぶり
蝸螺	にな
螟虫	ずいむし
螫蠅	さしばえ
螳螂	かまきり
螺子	ねじ
螺尻	ばいじり
螺旋	ねじ
螻蛄	けら
螽斯	きりぎりす
蟀谷	こめかみ
蟄石	かがみいし
蟇子	ぶゆ
蟇股	かえるまた
蟇蛙	ひきがえる
蟋蟀	こおろぎ
蟒蛇	うわばみ
蟬時雨	せみしぐれ
蟶貝	まてがい
蟷螂	かまきり
蟹足腫	ケロイド
蟾蜍	ひきがえる
蠅取蜘蛛	はえとりぐも
蠅虎	はえとりぐも
蠑蛇	いもり
蠑螈	いもり
蠹魚	しみ
血忌日	けこにち・ちいみび
行器	ほかい
行幸	みゆき
行方	ゆくえ
行火	アンカ
行狭	くだりせば
行秋	ゆくあき
行縢	むかばき
行纏	はばき
衛士府都	エジプト
衝立	ついたて
衝胴	かぶきどう
衝触る	ぶつける
衝重	ついがさね
衣呵華	アイオワ
衣衣	きぬぎぬ
衣被	きぬかつぎ
衣魚	しみ
表着	うわぎ
表衣	うえのきぬ
衵袴	あこめばかま
衽先	えりさき
衾雪	ふすまゆき
衿刳	えりぐり
袋熊	コアラ
袋鼠	カンガルー
被さる	かぶさる
被綿	きせわた
被衣	かずき
被風	はふ
裁着	たっつけ
裁衣	たっつけ
裂織	さっこり
裏店	うらだな
裏海	カスピかい
裙子	くんず
裙蔕菜	わかめ
裲襠	うちかけ
裳層	もこし
裳階	もこし
裸足	はだし
褄赤長吻虻	ツマアキツリアブ
褌祝	へこいわい
褞袍	どてら
褻れ衣	なれごろも
襁褓	おしめ／むつき
襤褸	ぼろ
襦袢	ジュバン
襯衣	シャツ
西奈	シナイ
西施舌	みるくい
西比利亜	シベリア
西浄	セイチン
西班牙	スペイン
西蔵	チベット
西貢	サイゴン
西風	ならい
要黐	かなめもち
覆盆子	いちご
覇王樹	サボテン
見処	みどころ
見風乾	あかしで
規尼涅	キニーネ
規那	キナ
視告朔	こうさく
覗機関	のぞきからくり
親不知	おやしらず
親族	うから
親許	おやもと
角力	すもう
角子	みずら
角宿	すぼし
角盥	つのだらい
角髪	みずら
角鴟	みみずく
角鷹	くまたか
觜宿	とろきぼし
解れる	ほつれる
解夏	げげ
解由状	げゆじょう
解部	ときべ
触虫	ふなむし
言伝	ことづて
託言	かごと
訛声	だみごえ
許多	あまた
許婚	いいなずけ
許嫁	いいなずけ
詞書	ことばがき
話聖臥東	ワシントン
該撒	シーザー
該里酒	シェリーしゅ
誓湯	くかたち・うけいゆ
誣言	しいごと
説道	いうならく
読経	どきょう
誰哉行灯	たそやアンドン
誰某	たれがし
諳厄利亜	アングリア
諳喀剌	アンゴラ
諷言	そえごと
諸共	もろとも
諸刃	もろは
諸向	もろむき
諸子	もろこ
諸手	もろて
諸肌	もろはだ
諸膚	もろはだ
諸諸	もろもろ
諺文	おんもん
諾威	ノルウェー
諾曼的	ノルマンディー
諾貝爾	ノーベル
警蹕	みさきおい
譫言	うわごと
護田鳥	うすべ・うすめどり
護謨	ゴム
谷地	やち
豆娘	いととんぼ
豆幹	まめがら
豆汁	ごじる
豆瓣醤	トウバンジャン
豆田	まめふ
豆腐皮	ゆば
豈夫	まさか
豊前	ぶぜん
豊後	ぶんご
豚脂	ラード
象鼻虫	ぞうむし
豪猪	やまあらし
豹脚蚊	やぶか
貌佳草	かおよぐさ
貌利太仁亜	ブリタニア
貝加爾	バイカル
貝多芬	ベートーベン
貝寄風	かいよせ
貝独楽	ベイごま／バイごま
貞享暦	じょうきょうれき
負所	おっしょ
販女	ひさぎめ
販婦	ひさぎめ
貫木	かんぬき
貫衆	やぶそてつ
責付く	せっつく・せつく
貲布	さいみ
貴人	あてびと
貴方	あなた
貸稲	いらしのいね
費府	フィラデルフィア
費爾治尼亜	バージニア
賎稲	しとで
賜物	たまもの
賞でる	めでる
賢木	さかき
賭弓／賭射	のりゆみ
賽子	さいころ
贓贖司	あがないもののつかさ
贖児	あがちご
赤保留古	アカプルコ
赤児	あかご
赤卒	あかえんば
赤口	しゃっく
赤古里	チョゴリ
赤垂柳	あかしで
赤小豆	しゃくしょうず
赤栴檀	ひめしゃら
赤楝蛇	やまかがし
赤檮	いちい
赤狗母魚	あかえそ
赤目魚	めなだ
赤秀	あこう
赤箭	おにのやがら
赤紫	うすむらさき
赤練蛇	やまかがし
赤翡翠	あかしょうびん
赤苧	あかそ
赤蜻蛉	あかとんぼ
赤道国	エクアドル
赤銅	しゃくどう
赤飯	あかのまんま
赤魚	あかお
赤魚鯛	あこうだい
赤鱏	あかえい
赤鱛	あかえそ
赤麻	あかそ
赫芝	ヘルツ
赭土	そおに
走野老	はしりどころ
起居	たちい
起破風	むくりはふ
越南	ベトナム
越幾斯	エキス
越橘	こけもも
越瓜	しろうり
越石	こしこく
越訴	おっそ
越路	こしじ
越階	おっかい
趣駕	そくが
足半	あしなか
足搦	あしがら
足末	あなすえ
足枷	あしかせ
足結	あゆい
足袋	たび
足裏	あなうら
足許	あしもと
足間	あしあい
趺坐	あぐら
跣足	はだし
跨的馬拉	グアテマラ
路加伝	ルカデン
路得	ルター
路照	ロッテルダム
跳鯊	とびはぜ
蹈鞴	たたら
蹣跚縞	よろけじま
蹲踞	つくばい
蹲鴟	いもがしら
蹴球	サッカー
躄魚	いざりうお
躑躅	つつじ
身体	からだ
身動ぎ	みじろぎ
身屋	もや
身形	みなり
身拭	みのごい
身柱	ちりけ
身柱元	ちりけもと
身舎	もや
身許	みもと
車前	おおばこ
車前草	おおばこ
車厘	ゼリー
軍鶏	しゃも
軟障	ぜじょう
転びつ	まろびつ
転ぶ	まろぶ
転寝	ごろね
軫宿	みつかけぼし
軽忽	きょうこつ
軽籠	かるこ
軽衫	カルサン
軽軽	きょうきょう
輪子	りゅうご
輪舞曲	ロンド
輪貫	わぬき
輪鼓	りゅうご
辛夷	こぶし
辞む	いなむ
辱号	ぞくごう
辺西威業	ペンシルバニア
辻褄	つじつま
近江	おうみ
迫間	はざま
迷子	まいご
迹門	シャクモン
追儺	おにやらい
追捕	ついぶ
追而書	おってがき
追風	おいて
退る	すさる
退紅	あらぞめ
送南風	おくりまぜ
送球	ハンドボール
逃散	ちょうさん
逆上せる	のぼせる
逆児	さかご
逆戟	さかまた
逆浪	さかなみ
逆焼	ほそけ
逆虎落	さかもがり
透波	すっぱ
透百合	すかしゆり
透綾	すきや
這子	ほうこ
通古斯	ツングース
通条花	きぶし
通泉草	さぎごけ
通草	あけび
速歩	はやあし
速香	すこう
造酒児	さかつこ
造酒司	みきのつかさ
造酒童女	さかつこ
連枝草	うまごやし
連枷	からざお／からさお
連玉	レダマ
連銭草	かきどおし
逸る	はやる
遁にする	しりごみする
遂遂	とうとう
遅遅	ぐずぐず・のそのそ
遊歴	ユウレキ
遊行	ユギョウ
遊行柳	ゆぎょうやなぎ
遏撒爽	アスンシオン
道列	みちづら
道守荘	ちもりのしょう
道導	みちしるべ
道形	みちなり
道果	みちはか
道標	みちしるべ
道爾	ドイル
道祖土焼	さいとやき
道祖神	さえのかみ
道程	みちのり
道陸神	どうろくじん
達引	たてひき
達斯馬尼	タスマニア
達爾文	ダーウィン
達磨	ダルマ
達芬奇	ダビンチ
達迷斯	テムズ
遠志	おんじゃく
遠方	おちかた
遠江	とおとうみ
遠近	おちこち
遠離る	とおざかる
遣す	よこす
遣戸	やりど
適間	たまひま
遮莫	さもあらばあれ
遷化	せんげ
避球	ドッジボール
還礼	わんれい
那以加爾	ニジェール
那威	ノルウェー
那波里	ナポリ
邦哥	バンコク
郁子	むべ
郁李	にわうめ
郎女	いらつめ
郎子	いらつこ
部婁	ホウロウ
部屋	へや
部曲	かきべ
部領	ことり
郭公	ほととぎす
郭公花	ほととぎす
都児古	トルコ
鄂哥都加	オホーツク
酒垂焼	さかたりやき
酒寿	さかほがい
酒槽	さかぶね
酒祝	さかほがい
酒頰	さかづら
酔魚草	ふじうつぎ
酢漿草	かたばみ
酸塊	すぐり
酸棗	さねぶとなつめ
酸模	すいば
酸橘	すだち
酸漿	ほおずき
酸漿草	かたばみ
酸茎	すぐき
醂柿	さわしがき
醇酒	かたざけ
醜名	しこな
醜女	しこめ／ぶおんな
醜男	ぶおとこ
醢汁	しょっつる
醪酒	もろみざけ
醬蝦	あみ
采女	うねめ
釉薬	うわぐすり
里味陂	リバプール
里回	さとみ
里廻	さとみ
里斯本	リスボン
里昂	リヨン
里曲	さとみ
里蝦蟇	つちがえる
重傷	おもで
重播	しきまき
重籐	しげどう
重頭	がさつ
野分	のわき
野山薬	やまのいも
野幫間	のダイコ
野干玉	ぬばたま
野木瓜	むべ
野点	のだて
野狐	こんこん
野猪	くさいなぎ
野羊	やぎ
野老	ところ
野良	のら
野良仕事	のらシごと
野芝麻	おどりこそう
野菰	なんばんぎせる
野蚕	くわご
野蜀葵	みつば
野衾	のぶすま
野阜	のづかさ
野面	のもせ
野鴉椿	ごんずい
野鶲	のびたき
金亀子	こがねむし
金児	かなこ
金剛石	ダイヤモンド
金剛纂	やつで
金合歓	アカシヤ
金団	きんとん
金子雀	カナリア
金字塔	ピラミッド
金屎	かなくそ
金巾	カナキン
金平糖	コンペイトー
金打	きんちょう
金椀	かなまり
金橘	キンカン
金沸草	おぐるま
金海鼠	きんこ
金漆	こしあぶら
金瘡小草	きらんそう
金盥	かなだらい
金神	こんじん
金米糖	コンペイトー
金粟蘭	ちゃらん
金糸桃	びようやなぎ
金糸雀	カナリア
金糸魚	いとよりだい
金線草	みずひき
金線蛙	とのさまがえる
金線魚	いとよりだい
金縷梅	まんさく
金翅雀	ひわ
金花虫	はむし
金英草	はなびしそう
金萱	ひめかんぞう
金衣公子	うぐいす
金襖子	かじかがえる
金鉗	かなばし
金鐘児	すずむし
金門	ゴールデンゲート
金雀児	えにしだ
金雀枝	えにしだ
金魚蝨	ちょう
針土竜	はりもぐら
針孔	みず／めど
針槐	はりえんじゅ
針眼	みず
針魚	さより
釡殿	かなえどの
釵子股	ぼうらん
鈍ましい	おぞましい
鈍ら	なまくら
鈍根草	みょうが
鈍甲	どんこ
鈍者	なまくらもの
鈍鈍	のろのろ
鈍間	のろま
鉄刀木	たがやさん
鉄嘴	ピンセット
鉄掃箒	めどはぎ
鉄樹	そてつ
鉄気	かなけ
鉄漿	おはぐろ／かね
鉄線蓮	てっせん
鉄脚梨	ぼけ
鉄葉	ブリキ
鉄蕉	そてつ
鉈彫	なたぼり
鉈豆	なたまめ
鉗む	つぐむ
鉛絶斯	ガンジス
鉤樟	くろもじ
鉤状	かぎなり
鉤素	はりす
銀名	ギニア
銀宝	ぎんぽ
銀杏	いちょう
銀杏返し	いちょうがえし
銀漢	あまのがわ
銀魚	しらうお
銅公事	あかがねくじ
銚子	さしなべ
銚釐	ちろり
銭占	ぜにうら
銭緡	ぜにさし
鋏虫	はさみむし
錏屋根	しころやね
錦帯花	はこねうつぎ
錦葵	ぜにあおい
錫崙	スリランカ
錫蘭	セイロン
鍍金	めっき
鍛冶	かじ
鎌柄	かまつか
鎌鼬	かまいたち
鎖す	とざす
鎗烏賊	やりいか
鎧球	アメリカンフットボール
鎬垂	しのだれ
鎮花祭	はなしずめのまつり
鎮魂	たましずめ
鎮魂歌	レクイエム
鎰取	かぎとり
鎺金	はばきがね
鏑矢	かぶらや
鐙靼	みずお
長亀	おさがめ
長刀	なぎなた
長吻虻	つりあぶ
長官	かみ
長寿花	きずいせん
長尾驢	カンガルー
長尾鶏	さざなみ
長庚	ゆうずつ
長押	なげし
長簀鯨	ながすくじら
長道	ながじ
長門	ながと
長閑	のどか
門土里留	モントリオール
門得爾	メンデル
門球	ゲートボール
閃閃	ひらひら
間八	かんぱち
間服	あいふく
間着	あいぎ
間道	かんとう
関谷黌	しずたにこう
閧都拉斯	ホンジュラス
閻魔蟋蟀	えんまこおろぎ
闍娑	ジャワ
闘球	ラグビー
阨入多	エジプト
防人	さきもり
防已	つづらふじ
防鴨河使	ぼうかし
阿利布	オリーブ
阿利襪	オリーブ
阿剌吉	アラキ
阿夢森	アムンゼン
阿弗利加	アフリカ
阿拉巴麻	アラバマ
阿拉斯加	アラスカ
阿波	あわ
阿海阿	オハイオ
阿爾及	アルジェリア
阿爾日耳	アルジェ
阿膠	あきょう
阿茶羅漬	アチャラづけ
阿蘭陀	オランダ
阿遅鴨	あじがも
阿里蘇那	アリゾナ
限限	ぎりぎり
除目	じもく
陪堂	ほいとう
陰囊	ふぐり
陰地蕨	はなわらび
陰日向	かげひなた
陰核	へのこ
陰蝨	つぶじらみ
陰行草	ひきよもぎ
陳生姜	ひねしょうが
陳者	のぶれば
陶器	すえき
陶工	すえつくり
陶物	すえもの
陸奥	みちのく／むつ
陸尺	ロクシャク
陸屋根	ろくやね
陸湯	おかゆ
陸稲	おかぼ
陸路	くがじ
陽炎	かげろう／かぎろい
隈回	くまみ
階隠	はしかくし
随に	まにまに
随神	かんながら
障泥	あおり
障泥烏賊	あおりいか
隠処	かくれが
隠岐	おき
隧道	トンネル
隼人	はやと
隼人瓜	はやとうり
雀の小笥	すずめのおごけ
雀の苧桶	すずめのおごけ
雀卵斑	そばかす
雀斑	そばかす
雀躍	こおどり
雀鷂	つみ
雀鷹	つみ
雁来月	かりきづき
雁来紅	はげいとう
雄鳥	おんどり
雅典	アテネ
雅楽寮	うたリョウ
雅楽頭	うたのかみ
集会	しゅえ
集注	しっちゅう
集礼	しゅらい
雇仲居	やとな
雇女	やとな
雉子	きじ／きぎす／きぎし
雉焼	きじやき
雉蓆	きじむしろ
雉隠	きじかくし
雉鳩	きじばと
雌鯒	めごち
雌鳥	めんどり
雎鳩	みさご
雑未耶	ザビエル
雑魚	ざこ
雑魚寝	ざこね
雛妓	おしゃく
雛罌粟	ひなげし
雛霰	ひなあられ
離州	りす
離離	かれがれ
難平	なんぴん
雨久花	みずあおい
雨合羽	あまガッパ
雨打	ゆた
雨果	ユゴー
雨滴	あまだれ
雨疏	あまはけ
雨虎	あめふらし
雨霰	あめあられ
雪垂	ゆきしずり
雪婆	ゆきばんば
雪山	ヒマラヤ
雪崩	なだれ
雪洞	ぼんぼり
雪消	ゆきげ
雪特尼	シドニー
雪礫	ゆきつぶて
雪花菜	きらず
雪袴	もんぺ
雪踏	せった
雪達磨	ゆきダルマ
雪際亜	スエーデン
雪隠金亀子	せんちこがね
雪風巻	ゆきしまき
雲丹	うに
雲母	きらら
雲珠	うず
雲立涌	くもたてわく
雲脂	ふけ
雲葉	やまぐるま
雲雀	ひばり
零余子	むかご
雷無月	かみなかりづき
雷諾阿	ルノアール
雷魚	はたはた
震震	ぶるぶる
霍公鳥	ほととぎす
霙酒	みぞれざけ
霰餅	あられもち
露兜樹	たこのき
露西亜	ロシア
露隠端月	つゆこもりはつき
霹靂	かみとき
霹靂神	はたたがみ
霾晦	よなぐもり
青底翳	あおそこひ
青柳	あおやぎ
青椒肉糸	チンジャオロースー
青沙魚	あいざめ
青海波	せいがいは
青海苔	あおのり
青竜蝦	しゃこ
青箭魚	さごし
青緡	あおざし
青繦	あおざし
青芋	さといも
青花魚	さば
青苔	あおのり
青苧	あおそ
青茅	かりやす
青萍	あおうきくさ
青葉木菟	あおばずく
青葉梟	あおばずく
青蝦	しばえび
青蠅	きんばえ
青鈍	あおにび
青頭菌	はつたけ
青魚	さば
青麻	あおそ
静寂	しじま
非伯林	ツェッペリン
面懸	おもがい
面瘡	おもくさ
面皰	にきび
面繫	おもがい
革茸	こうたけ
靫負	ゆげい
鞆音	ともね
鞋底魚	したびらめ
鞠挟	まりばさみ
鞣革	なめしがわ
鞭撒武	ベンサム
韋柏	ウェーバー
韋白斯特	ウェブスター
韓紅	からくれない
韓衣	からころも
韓鍛冶部	からのかぬちべ
韜留	トゥールーズ
韮葱	リーキ
音呼	いんこ
音声	おんじょう
響めく	どよめく
響尾蛇	がらがらへび
響銅	さはり
頁	おおがい
頂相	ちんぞう
頂辺	てへん
頑癬	たむし
領巾	ひれ
領髪	えりがみ
頭垢	ふけ
頭形	ずなり
頭椎	かぶつち
頭槌・頭椎	かぶつち
頰杖	つらづえ
頰貫	つらぬき
頰輔	ほおがまち
頸枷	くびかせ
頽れる	くずおれる
頽薬	なだれ
顋門	ひよめき
額列那大	グレナダ
顔容	かおかたち
顔貌	かおかたち
顕理	ヘンリー
顕証	けそう
顚蕀	くさすぎかずら
顳顬	こめかみ
風信子	ヒヤシンス
風巻	しまき
風邪	かぜ
颯颯織	ざざんざおり
飄石	ずんばい
飛沫	しぶき
飛白	かすり
飛礫	つぶて
飛蝗	ばった
飛螻蛄	とびけら
飛蟻	はあり
飛魚	あご
飛鳥	あすか
食単	メニュー
食火鶏	ひくいどり
食籠	じきろう
食蟻獣	ありくい
飢える	かつえる
飯事	ままごと
飯匙倩	はぶ
飯櫃	めしびつ／いびつ
飯櫃入	おはちいれ
飯粒	いいぼ
飾山囃子	おやまばやし
餅膚	もちはだ
餌畚	えふご
餌香市	えがのいち
饅鱠	ぬたなます
首座	しゅそ
首枷	くびかせ／くびかし
首級	しるし
首途	かどで
香具師	やし
香匙	こうすくい
香椿	ちゃんちん
香橘	くねんぼ
香欒	ザボン
香港	ホンコン
香色	こういろ
香蒲	がま
香蕈	しいたけ
香螺	ながにし
香魚	あゆ
馬の陰貝	うまのくぼがい
馬克	マルク
馬克思	マルクス
馬克斯維耳	マクスウェル
馬兜鈴	うまのすずくさ
馬内	マネ
馬刀葉椎	まてばしい
馬刀貝	まてがい
馬勃	ほこりだけ
馬可波羅	マルコポーロ
馬哈黙	マホメット
馬唐	おひしば
馬喰	ばくろう
馬基雅弗利	マキャベリ
馬基頓	マケドニア
馬塞	うませ
馬塞棒	ませボウ
馬太	マタイ
馬尼剌	マニラ
馬尾毛	ばす
馬尾藻	ほんだわら
馬徳里	マドリード
馬搭喇	マドラス
馬来	マレー
馬柵	うませ
馬梳	まぐし／うまぐし
馬標	うまじるし
馬浜	バハマ
馬爪	ばず
馬爾太	マルタ
馬琴力	マッキンリー
馬的遜	マディソン
馬耳塞	マルセイユ
馬蛤貝	まてがい
馬蹄草	かきどおし
馬道	めどう
馬達加斯	マダガスカル
馬酔木	あせび／あしび
馬銜	はみ
馬陸	やすで
馬鞭草	くまつづら
馬鮫魚	さわら
馴鮨	なれずし
馴鹿	トナカイ
駄洒落	ダじゃれ
駄袋	だんぶくろ
駅馬	はゆま
駕籠	かご
駕籠舁	かごかき
駿河	するが
騎弓	うまゆみ
騒騒	さいさい
驀地	まっしぐら
驀直	まっしぐら
驕誇	きょうか
骨牌	カルタ
骨項	おおばん
骰子	さいころ
髑髏	されこうべ
高加索	コーカサス
高卓	たかじょく
高坏	たかつき／たかすき
高御座	たかみくら
高襟	ハイカラ
高陽院	かやのいん
高麗笛	こまぶえ
高麗鼠	こまねずみ
高鼾	たかいびき
髪菜	いぎす
髪際	こうぎわ
髫髪	うない
髭籠	ひげこ
髱髪	たぼがみ
髷物	まげもの
髻華	うず
鬢枇	びんそぎ
鬢除	びんそぎ
鬣犬	ハイエナ
鬨頭	ときがしら
鬱金香	チューリップ
鬼婆	おにばば
鬼宿	たまおのぼし
鬼灯	ほおずき
鬼百合	おにゆり
鬼薊	おにあざみ
鬼蜻蜓	おにやんま
鬼鍼草	せんだんぐさ
鬼頭魚	しいら
魑魅	すだま
魔利提列瑣	マリアテレジア
魚味始	まなはじめ
魚子	ななこ
魚屋	ととや
魚条	すわやり
魚河岸	うおがし
魚狗	かわせみ
魚籃	びく
魚籠	びく
魚虎	はりせんぼん／かわせみ
魯安達	ルワンダ
魯本玆	ルーベンス
魯西安納	ルイジアナ
鮎並	あいなめ
鮎魚女	あいなめ
鮒膾	ふななます
鮸膠	にべ
鯉幟	こいのぼり
鯔背	いなせ
鯔背銀杏	いなせいちょう
鯣烏賊	するめいか
鯨波	とき
鯰髭	なまずひげ
鰊の子	かどのこ
鰊群来	にしんくき
鰥夫	やもお
鰾膠	にべ
鱓魚	うつぼ
鱟魚	かぶとがに
鱠残魚	しらうお
鱧腸	たかさぶろう
鱲子	からすみ
鳥交る	とりさかる
鳥威	とりおどし
鳥座	とぐら
鳥栖	とぐら
鳥渡	ちょっと
鳥甲	とりかぶと
鳥総松	とぶさまつ
鳥膚	とりはだ
鳥臓	ももき
鳥頬魚	くろだい
鳥黐	とりもち
鳩尾	みぞおち
鳩酸草	かたばみ
鳳尾松	そてつ
鳳梨	パイナップル
鳳蝶	あげはちょう
鳴子百合	なるこゆり
鳶尾	いちはつ
鴉葱	しらいとそう
鴛鴦	おしどり
鴟尾草	いちはつ
鴨嘴獣	かものはし
鴨脚樹	いちょう
鴨舌草	こなぎ
鴨足藤	きんぎょそう
鴨跖草	つゆくさ
鴨頭	こうとう
鴾母	ふなしうずら
鴾毛	つきげ
鵞梅	ぶんごうめ
鵞毛玉鳳花	さぎそう
鵞耳櫪	さわしば
鵯花	ひよどりばな
鵲豆	ふじまめ
鶉斑	うずらふ
鶉豆	うずらまめ
鶏児腸	よめな
鶏冠	とさか
鶏冠木	かえで
鶏冠海苔	とさかのり
鶏冠菜	とさかのり
鶏桑	やまぐわ
鶏目	うおのめ
鶏眼草	やはずそう
鶏腸草	はこべ
鶏魚	いさき
鶏麻	しろやまぶき
鶤鶏	とうまる
鶴嘴	つるはし
鶴脛	つるはぎ
鶸色	ひわいろ
鶺鴒	にわたたき
鷦鷯	みそさざい
鷸子	つぶり
鷹居	たかすえ
鷹斑鷸	たかぶしぎ
鷽替	うそかえ
鹹漬	からづけ
鹹草	あしたば
鹿垣	ししがき
鹿尾菜	ひじき
鹿杖	かせづえ
鹿毛	かげ
鹿火屋	かびや
鹿特担	ロッテルダム
鹿砦	さかもぎ
鹿茸	ふくろづの
鹿葱	なつずいせん
鹿薬	ゆきざさ
鹿角	かづの
鹿角菜	ひじき
鹿蹄草	いちやくそう
鹿驚	かかし
麗春花	ひなげし
麝香葡萄	マスカット
麦加	メッカ
麦哲倫	マゼラン
麦索	むぎなわ
麦薯蕷	むぎとろ
麦酒	ビール
麦門冬	じゃのひげ
麦魚	めだか
麺麭	パン
麻代父	モルディブ
麻幹	おがら
麻斉崙	マゼラン
麻栗樹	チーク
麻疹	はしか
麻耳克	マルク
麻葉繡毬	こでまり
麻魚	しびれえい
黄丹衣	きあかのきぬ
黄土色	おうどいろ
黄岑	おうごん
黄心樹	おがたまのき
黄昏	たそがれ
黄楊	つげ
黄槿	はまぼう
黄檗	きはだ
黄櫨	はぜのき
黄泉	よみ
黄泉路	よみじ
黄牛	あめうし
黄瑞香	みつまた
黄瓜	きゅうり
黄瓜菜	にがな
黄精	なるこゆり
黄紫茸	きむらたけ
黄絹	ほっけん
黄色蛇	あおだいしょう
黄花苗	たんぽぽ
黄花郎草	たんぽぽ
黄葉	もみじ
黄葵	とろろあおい
黄蜀葵	とろろあおい
黄身時雨	きみしぐれ
黄連花	くされだま
黄道眉	ほおじろ
黄鳳蝶	きあげは
黄鶏	かしわ
黄鶲	きびたき
黄麻	いちび／つなそ
黄鼠	てん
黍魚子	きびなご
黎巴嫩	レバノン
黐竿	もちざお
黒三稜	みくり
黒南風	くろはえ
黒参	ごまのはぐさ
黒子	ほくろ
黒山	モンテネグロ
黒布	くろめ
黒智爾	ヘーゲル
黒桃花毛	くろつきげ
黒框	くろわく
黒檜	くろべ
黒死病	ペスト
黒海布	くろめ
黒竜江	アムール
黒紫	こきむらさき
黒菜	くろめ
黒衣	くろご／くろこ
黒酒	くろき
黒駁	くろぶち
黒鴾毛	くろつきげ
黙加	メッカ
黠戛斯	キルギス
黴雨	つゆ
黶子	ほくろ
鼓子花	ひるがお
鼓虫	みずすまし
鼓豆虫	みずすまし
鼠坊	ねずっぽ
鼠李	くろうめもどき
鼠麴草	ははこぐさ
鼠黐	ねずみもち
鼬魚	いたちうお
鼬鼠	いたち
鼯鼠	むささび／ももんが
鼴鼠	もぐら
鼻茸	はなたけ
齋蒿	うはぎ
齢草	よわいぐさ
齲歯	むしば
龍動	ロンドン
龐太我刺私	ピタゴラス